date,state,positive,negative,pending,hospitalizedCurrently,hospitalizedCumulative,inIcuCurrently,inIcuCumulative,onVentilatorCurrently,onVentilatorCumulative,recovered,dataQualityGrade,lastUpdateEt,dateModified,checkTimeEt,death,hospitalized,dateChecked,fips,positiveIncrease,negativeIncrease,total,totalTestResults,totalTestResultsIncrease,posNeg,deathIncrease,hospitalizedIncrease,hash,commercialScore,negativeRegularScore,negativeScore,positiveScore,score,grade
20200610,WA,24354,390700,,238,3747,,,92,,,B,"Wed, 10 Jun 2020 05:59:00 GMT",2020-06-10T05:59:00Z,06/10 01:59,1176,3747,2020-06-10T05:59:00Z,53,313,4451,415054,415054,4764,415054,15,48,277eac6f9afacb995b22ad8474d112f70bef0efd,0,0,0,0,0,
20200609,WA,24041,386249,,205,3699,,,60,,,B,"Mon, 08 Jun 2020 05:59:00 GMT",2020-06-08T05:59:00Z,06/08 01:59,1161,3699,2020-06-08T05:59:00Z,53,312,4922,410290,410290,5234,410290,2,30,bea2cfef6c83eddef511efee15a940a5fbaf5ca7,0,0,0,0,0,
20200608,WA,23729,381327,,213,3669,,,66,,,B,"Sun, 07 Jun 2020 05:59:00 GMT",2020-06-07T05:59:00Z,06/07 01:59,1159,3669,2020-06-07T05:59:00Z,53,287,4181,405056,405056,4468,405056,6,17,142e5dd5f5cf5999dfaecc0765dbadbac24d7c4e,0,0,0,0,0,
20200607,WA,23442,377146,,205,3652,,,57,,,B,"Sat, 06 Jun 2020 05:59:00 GMT",2020-06-06T05:59:00Z,06/06 01:59,1153,3652,2020-06-06T05:59:00Z,53,273,-202,400588,400588,71,400588,4,13,c4dfd74e78cd270aca9ab6d4325ff57c948b19de,0,0,0,0,0,
20200606,WA,23169,377348,,247,3639,,,86,,,B,"Sat, 06 Jun 2020 05:59:00 GMT",2020-06-06T05:59:00Z,06/06 01:59,1149,3639,2020-06-06T05:59:00Z,53,0,0,400517,400517,0,400517,11,24,a63a302e69e292bbeb53ccdcddd358da28449372,0,0,0,0,0,
20200605,WA,23169,377348,,285,3615,,,91,,,B,"Fri, 05 Jun 2020 03:00:00 GMT",2020-06-05T03:00:00Z,06/04 23:00,1138,3615,2020-06-05T03:00:00Z,53,22,1013,400517,400517,1035,400517,3,37,bc8afd65f394d5e508c6aa3279099a3e15aa4251,0,0,0,0,0,
20200604,WA,23147,376335,,272,3578,,,94,,,B,"Thu, 04 Jun 2020 05:59:00 GMT",2020-06-04T05:59:00Z,06/04 01:59,1135,3578,2020-06-04T05:59:00Z,53,70,2813,399482,399482,2883,399482,6,35,c04cfcfa7ad01dc485e4d60a09d04ebc47e695e5,0,0,0,0,0,
20200603,WA,23077,373522,,263,3543,,,89,,,B,"Wed, 03 Jun 2020 03:00:00 GMT",2020-06-03T03:00:00Z,06/02 23:00,1129,3543,2020-06-03T03:00:00Z,53,197,5009,396599,396599,5206,396599,5,26,a00aa12bd0bb5f9805283d5df952aee0ca913413,0,0,0,0,0,
20200602,WA,22880,368513,,232,3517,,,48,,,B,"Tue, 02 Jun 2020 03:00:00 GMT",2020-06-02T03:00:00Z,06/01 23:00,1124,3517,2020-06-02T03:00:00Z,53,277,6764,391393,391393,7041,391393,6,16,0e6260c2dad36cf71f65f571f5060d22b0579b75,0,0,0,0,0,
20200601,WA,22603,361749,,245,3501,,,52,,,B,"Mon, 01 Jun 2020 03:00:00 GMT",2020-06-01T03:00:00Z,05/31 23:00,1118,3501,2020-06-01T03:00:00Z,53,246,6669,384352,384352,6915,384352,0,21,9514966a0a9aea21c88d7dd075c33e974c7c45fc,0,0,0,0,0,
20200531,WA,22357,355080,,266,3480,,,67,,,B,"Sun, 31 May 2020 05:59:00 GMT",2020-05-31T05:59:00Z,05/31 01:59,1118,3480,2020-05-31T05:59:00Z,53,84,2165,377437,377437,2249,377437,7,25,1c0fd87a354a142f0095f1d22a62ec4f4e06747c,0,0,0,0,0,
20200530,WA,22273,352915,,319,3455,,,88,,,B,"Sat, 30 May 2020 05:59:00 GMT",2020-05-30T05:59:00Z,05/30 01:59,1111,3455,2020-05-30T05:59:00Z,53,114,3225,375188,375188,3339,375188,5,42,5c92c36c5a1d391d8e6f1d71fef5c51b839d76b9,0,0,0,0,0,
20200529,WA,22159,349690,,317,3413,,,85,,,B,"Fri, 29 May 2020 05:59:00 GMT",2020-05-29T05:59:00Z,05/29 01:59,1106,3413,2020-05-29T05:59:00Z,53,207,6078,371849,371849,6285,371849,11,19,f2f070655bb2221f9d7f7255e6f37ff3638b49cd,0,0,0,0,0,
20200528,WA,21952,343612,,325,3394,,,94,,,B,"Wed, 27 May 2020 05:59:00 GMT",2020-05-27T05:59:00Z,05/27 01:59,1095,3394,2020-05-27T05:59:00Z,53,194,6067,365564,365564,6261,365564,17,56,477bcb8fbfad3a30fa1407b3efed8cb9069c2aa3,0,0,0,0,0,
20200527,WA,21758,337545,,241,3338,,,53,,,B,"Tue, 26 May 2020 05:59:00 GMT",2020-05-26T05:59:00Z,05/26 01:59,1078,3338,2020-05-26T05:59:00Z,53,236,6455,359303,359303,6691,359303,8,48,be73b2fda10c721ee7d9dc73feef26c1b653ddfd,0,0,0,0,0,
20200526,WA,21522,331090,,267,3290,,,51,,,B,"Mon, 25 May 2020 05:59:00 GMT",2020-05-25T05:59:00Z,05/25 01:59,1070,3290,2020-05-25T05:59:00Z,53,243,7607,352612,352612,7850,352612,9,3,b708ed934d31395ec671d397afd51fbd7eca7051,0,0,0,0,0,
20200525,WA,21279,323483,,207,3287,,,47,,,B,"Sun, 24 May 2020 05:59:00 GMT",2020-05-24T05:59:00Z,05/24 01:59,1061,3287,2020-05-24T05:59:00Z,53,209,2185,344762,344762,2394,344762,6,31,6773e360a42aced21d2f160454cfa4bf456e566d,0,0,0,0,0,
20200524,WA,21070,321298,,313,3256,,,74,,,B,"Sat, 23 May 2020 05:59:00 GMT",2020-05-23T05:59:00Z,05/23 01:59,1055,3256,2020-05-23T05:59:00Z,53,137,2125,342368,342368,2262,342368,5,26,7cd00646e57662a12444edccc5400f143ad6fe19,0,0,0,0,0,
20200523,WA,20933,319173,,332,3230,,,96,,,B,"Fri, 22 May 2020 05:59:00 GMT",2020-05-22T05:59:00Z,05/22 01:59,1050,3230,2020-05-22T05:59:00Z,53,186,2545,340106,340106,2731,340106,6,74,592d50868ccc73c2d6efe2754808af992f0ec61e,0,0,0,0,0,
20200522,WA,20747,316628,,332,3156,,,85,,,B,"Thu, 21 May 2020 05:59:00 GMT",2020-05-21T05:59:00Z,05/21 01:59,1044,3156,2020-05-21T05:59:00Z,53,265,5387,337375,337375,5652,337375,7,31,61dbfddda68c0e23b30b3e7e6d90abf172cdb891,0,0,0,0,0,
20200521,WA,20482,311241,,242,3125,,,70,,,B,"Wed, 20 May 2020 05:59:00 GMT",2020-05-20T05:59:00Z,05/20 01:59,1037,3125,2020-05-20T05:59:00Z,53,186,5612,331723,331723,5798,331723,6,3125,e9a76032c0d66a5f59e1fbd2a20ea9ce6c7f0927,0,0,0,0,0,
20200520,WA,20296,305629,,168,,52,,,,,B,"Tue, 19 May 2020 05:59:00 GMT",2020-05-19T05:59:00Z,05/19 01:59,1031,,2020-05-19T05:59:00Z,53,230,7026,325925,325925,7256,325925,29,0,c06b4bf15a20c171ef375e0066022f135ac7fbe2,0,0,0,0,0,
20200519,WA,20066,298603,,168,,52,,,,,A,"Mon, 18 May 2020 05:59:00 GMT",2020-05-18T05:59:00Z,05/18 01:59,1002,,2020-05-18T05:59:00Z,53,238,8121,318669,318669,8359,318669,1,0,07d6c2d58db5e042e720bd6b542e810e50734525,0,0,0,0,0,
20200518,WA,19828,290482,,168,,52,,,,,A,"Sun, 17 May 2020 05:59:00 GMT",2020-05-17T05:59:00Z,05/17 01:59,1001,,2020-05-17T05:59:00Z,53,275,7884,310310,310310,8159,310310,1,0,4c02fe8e4f3ad337afda6694a78201f97716bf99,0,0,0,0,0,
20200517,WA,19553,282598,,168,,52,,,,,A,"Sun, 17 May 2020 03:00:00 GMT",2020-05-17T03:00:00Z,05/16 23:00,1000,,2020-05-17T03:00:00Z,53,146,1778,302151,302151,1924,302151,8,0,c1e021155f0a163529ea16945b3af259278cd681,0,0,0,0,0,
20200516,WA,19407,280820,,331,,90,,,,,A,"Sat, 16 May 2020 03:00:00 GMT",2020-05-16T03:00:00Z,05/15 23:00,992,,2020-05-16T03:00:00Z,53,183,2857,300227,300227,3040,300227,9,0,16aa3fe95c47df614a12c058fcac8954c7706cba,0,0,0,0,0,
20200515,WA,19224,277963,,374,,114,,,,,A,"Fri, 15 May 2020 03:00:00 GMT",2020-05-15T03:00:00Z,05/14 23:00,983,,2020-05-15T03:00:00Z,53,209,6295,297187,297187,6504,297187,8,0,019ed6613c97f8d5bbde27b8ca461a0d53c84072,0,0,0,0,0,
20200514,WA,19015,271668,,365,,111,,,,,A,"Thu, 14 May 2020 03:00:00 GMT",2020-05-14T03:00:00Z,05/13 23:00,975,,2020-05-14T03:00:00Z,53,235,5870,290683,290683,6105,290683,13,0,8403d0117807cdc6c7210bc2f9e437eb04318b05,0,0,0,0,0,
20200513,WA,18780,265798,,384,,114,,,,,A,"Wed, 13 May 2020 03:00:00 GMT",2020-05-13T03:00:00Z,05/12 23:00,962,,2020-05-13T03:00:00Z,53,218,6424,284578,284578,6642,284578,17,0,1ffc8e232d2c8937e5beb388e208763e23626f43,0,0,0,0,0,
20200512,WA,18562,259374,,321,,94,,,,,A,"Tue, 12 May 2020 03:00:00 GMT",2020-05-12T03:00:00Z,05/11 23:00,945,,2020-05-12T03:00:00Z,53,208,6226,277936,277936,6434,277936,14,0,4ae95f2a1813ea80d92d29f245649dbc15b2a520,0,0,0,0,0,
20200511,WA,18354,253148,,350,,110,,,,,B,"Mon, 11 May 2020 03:00:00 GMT",2020-05-11T03:00:00Z,05/10 23:00,931,,2020-05-11T03:00:00Z,53,281,5784,271502,271502,6065,271502,10,0,71adcfaba1c1643ce172be86ad86d1ae7998c0e1,0,0,0,0,0,
20200510,WA,18073,247364,,335,,101,,,,,B,"Sun, 10 May 2020 03:00:00 GMT",2020-05-10T03:00:00Z,05/09 23:00,921,,2020-05-10T03:00:00Z,53,167,1172,265437,265437,1339,265437,16,0,959ce18b018e2c83aed8b666cd335842917e90d6,0,0,0,0,0,
20200509,WA,17906,246192,,393,,128,,,,,B,"Sat, 09 May 2020 03:00:00 GMT",2020-05-09T03:00:00Z,05/08 23:00,905,,2020-05-09T03:00:00Z,53,148,2192,264098,264098,2340,264098,14,0,70976b3bf4d8e07bc4dc1b4f9a71b1af2cfc761e,0,0,0,0,0,
20200508,WA,17758,244000,,393,,122,,,,,B,"Fri, 08 May 2020 03:00:00 GMT",2020-05-08T03:00:00Z,05/07 23:00,891,,2020-05-08T03:00:00Z,53,205,6101,261758,261758,6306,261758,21,0,0f0dd7627ccf54ddb0f2ec24f5ec315ffff4a779,0,0,0,0,0,
20200507,WA,17553,237899,,358,,144,,,,,B,"Thu, 07 May 2020 03:00:00 GMT",2020-05-07T03:00:00Z,05/06 23:00,870,,2020-05-07T03:00:00Z,53,197,5706,255452,255452,5903,255452,8,0,c06b20aa2051779ad89f31683b4053c1f6a352fd,0,0,0,0,0,
20200506,WA,17356,232193,,390,,127,,,,,B,"Wed, 06 May 2020 03:00:00 GMT",2020-05-06T03:00:00Z,05/05 23:00,862,,2020-05-06T03:00:00Z,53,243,6978,249549,249549,7221,249549,21,0,88a246e03e2d0b7778674920f2a6e099fa440b70,0,0,0,0,0,
20200505,WA,17113,225215,,292,,102,,,,,B,"Tue, 05 May 2020 03:00:00 GMT",2020-05-05T03:00:00Z,05/04 23:00,841,,2020-05-05T03:00:00Z,53,260,6303,242328,242328,6563,242328,7,0,572cb6f812b8062239096803a13864aea0e669ce,0,0,0,0,0,
20200504,WA,16853,218912,,263,,86,,,,,B,"Mon, 04 May 2020 03:00:00 GMT",2020-05-04T03:00:00Z,05/03 23:00,834,,2020-05-04T03:00:00Z,53,259,6727,235765,235765,6986,235765,4,0,d5af8c3cb7498d010cbc127a6b6a258f751e1bfc,0,0,0,0,0,
20200503,WA,16594,212185,,411,,120,,,,,B,"Sun, 03 May 2020 03:00:00 GMT",2020-05-03T03:00:00Z,05/02 23:00,830,,2020-05-03T03:00:00Z,53,139,1363,228779,228779,1502,228779,6,0,078bc8a9a566a2f742595abfad31c1ac504fda35,0,0,0,0,0,
20200502,WA,16455,210822,,428,,117,,,,,B,"Sat, 02 May 2020 03:00:00 GMT",2020-05-02T03:00:00Z,05/01 23:00,824,,2020-05-02T03:00:00Z,53,148,2612,227277,227277,2760,227277,10,0,896331378092d95dfd6da9c48a105ee9e55ae249,0,0,0,0,0,
20200501,WA,16307,208210,,470,,120,,,,,B,"Fri, 01 May 2020 03:00:00 GMT",2020-05-01T03:00:00Z,04/30 23:00,814,,2020-05-01T03:00:00Z,53,345,6434,224517,224517,6779,224517,13,0,a5661c22cbe8490ae3651817b8e24744273e8666,0,0,0,0,0,
20200430,WA,15962,201776,,474,,145,,,,,B,"Thu, 30 Apr 2020 03:00:00 GMT",2020-04-30T03:00:00Z,04/29 23:00,801,,2020-04-30T03:00:00Z,53,261,6235,217738,217738,6496,217738,15,0,06b9d35ace7086506bc372cba4a237d8616b1ac4,0,0,0,0,0,
20200429,WA,15701,195541,,490,,156,,,,,B,"Wed, 29 Apr 2020 03:00:00 GMT",2020-04-29T03:00:00Z,04/28 23:00,786,,2020-04-29T03:00:00Z,53,242,6568,211242,211242,6810,211242,21,0,b6321e40870aeabab298e40e22bfd1194e289dad,0,0,0,0,0,
20200428,WA,15459,188973,,436,,158,,,,,B,"Tue, 28 Apr 2020 03:00:00 GMT",2020-04-28T03:00:00Z,04/27 23:00,765,,2020-04-28T03:00:00Z,53,234,6695,204432,204432,6929,204432,16,0,2227df77ae877128c5a73e15a85936342d605bfd,0,0,0,0,0,
20200427,WA,15225,182278,,536,,115,,,,,B,"Mon, 27 Apr 2020 03:00:00 GMT",2020-04-27T03:00:00Z,04/26 23:00,749,,2020-04-27T03:00:00Z,53,273,7022,197503,197503,7295,197503,11,0,f8f374a9030478a4b61c5805612cc3752eb6ed17,0,0,0,0,0,
20200426,WA,14952,175256,,508,,145,,,,,B,"Sun, 26 Apr 2020 03:00:00 GMT",2020-04-26T03:00:00Z,04/25 23:00,738,,2020-04-26T03:00:00Z,53,179,1577,190208,190208,1756,190208,73,0,1dbeb257ca445af26433a0119c13f6effa4063a0,0,0,0,0,0,
20200425,WA,14773,173679,,455,,174,,,,,B,"Sat, 25 Apr 2020 03:00:00 GMT",2020-04-25T03:00:00Z,04/24 23:00,665,,2020-04-25T03:00:00Z,53,192,3258,188452,188452,3450,188452,6,0,bdc1a43239114629b64914723734a79d909a23a0,0,0,0,0,0,
20200424,WA,14581,170421,,551,,164,,,,,C,"Fri, 24 Apr 2020 03:00:00 GMT",2020-04-24T03:00:00Z,04/23 23:00,659,,2020-04-24T03:00:00Z,53,287,6715,185002,185002,7002,185002,5,0,64e10f3953054f5c238142f1b9a3abdb9ebb30a7,0,0,0,0,0,
20200423,WA,14294,163706,,544,,151,,,,,C,"Thu, 23 Apr 2020 03:00:00 GMT",2020-04-23T03:00:00Z,04/22 23:00,654,,2020-04-23T03:00:00Z,53,254,5269,178000,178000,5523,178000,7,0,3c97aaf5ad93751663a4c9581e3afeac9d7affe5,0,0,0,0,0,
20200422,WA,14040,158437,,543,,161,,,,,C,"Wed, 22 Apr 2020 03:00:00 GMT",2020-04-22T03:00:00Z,04/21 23:00,647,,2020-04-22T03:00:00Z,53,238,5109,172477,172477,5347,172477,7,0,85e2bd5aad468edfebe2df06f2e6bab267dde345,0,0,0,0,0,
20200421,WA,13802,153328,,503,,161,,,,,C,"Tue, 21 Apr 2020 03:00:00 GMT",2020-04-21T03:00:00Z,04/20 23:00,640,,2020-04-21T03:00:00Z,53,241,4920,167130,167130,5161,167130,11,0,d32f736835c206bcb1c20d8374bcab614de72c47,0,0,0,0,0,
20200420,WA,13561,148408,,403,,122,,,,,C,"Mon, 20 Apr 2020 03:00:00 GMT",2020-04-20T03:00:00Z,04/19 23:00,629,,2020-04-20T03:00:00Z,53,305,4545,161969,161969,4850,161969,14,0,4b2d1ba1443eeb508bcb2b186321ddeced075d15,0,0,0,0,0,
20200419,WA,13256,143863,,586,,193,,,,,C,"Sun, 19 Apr 2020 03:00:00 GMT",2020-04-19T03:00:00Z,04/18 23:00,615,,2020-04-19T03:00:00Z,53,174,1443,157119,157119,1617,157119,17,0,9d13d19068bd70e526deff1258b7489983321e53,0,0,0,0,0,
20200418,WA,13082,142420,,518,,155,,,,,C,"Sat, 18 Apr 2020 03:00:00 GMT",2020-04-18T03:00:00Z,04/17 23:00,598,,2020-04-18T03:00:00Z,53,233,2011,155502,155502,2244,155502,13,0,80a7d2102ff347af6e8ea589a93c5aace8312557,0,0,0,0,0,
20200417,WA,12849,140409,,622,,195,,,,,C,"Fri, 17 Apr 2020 03:00:00 GMT",2020-04-17T03:00:00Z,04/16 23:00,585,,2020-04-17T03:00:00Z,53,301,4147,153258,153258,4448,153258,14,0,9ee96e1504fe8aaf1542f7bec3286e781cb491a7,0,0,0,0,0,
20200416,WA,12548,136262,,595,,196,,,,,C,"Thu, 16 Apr 2020 03:00:00 GMT",2020-04-16T03:00:00Z,04/15 23:00,571,,2020-04-16T03:00:00Z,53,255,4092,148810,148810,4347,148810,20,0,a569092233e8904f26c2e5534349857c770e011f,0,0,0,0,0,
20200415,WA,12293,132170,,645,,194,,,,,C,"Wed, 15 Apr 2020 03:00:00 GMT",2020-04-15T03:00:00Z,04/14 23:00,551,,2020-04-15T03:00:00Z,53,312,3832,144463,144463,4144,144463,9,0,36342551f2f2e272c4259e4e0d4efb39627112e9,0,0,0,0,0,
20200414,WA,11981,128338,,387,,98,,,,,C,"Tue, 14 Apr 2020 03:00:00 GMT",2020-04-14T03:00:00Z,04/13 23:00,542,,2020-04-14T03:00:00Z,53,224,4066,140319,140319,4290,140319,16,0,f8b87b727d2dfbe2d695a4ec7bf59827925c303e,0,0,0,0,0,
20200413,WA,11757,124272,,527,,166,,,,,C,"Mon, 13 Apr 2020 03:00:00 GMT",2020-04-13T03:00:00Z,04/12 23:00,526,,2020-04-13T03:00:00Z,53,300,3900,136029,136029,4200,136029,17,0,f25ff0e557010151613faf737e8aa197964c2448,0,0,0,0,0,
20200412,WA,11457,120372,,642,,191,,,,,C,"Sun, 12 Apr 2020 03:00:00 GMT",2020-04-12T03:00:00Z,04/11 23:00,509,,2020-04-12T03:00:00Z,53,167,1264,131829,131829,1431,131829,15,0,b3d2c5876151aec50e06ee1143aa366df1a1fce5,0,0,0,0,0,
20200411,WA,11290,119108,,649,,191,,,,,C,"Sat, 11 Apr 2020 03:00:00 GMT",2020-04-11T03:00:00Z,04/10 23:00,494,,2020-04-11T03:00:00Z,53,210,1867,130398,130398,2077,130398,18,0,dae71c17aca42e604eb03a83334cf53736ec82a5,0,0,0,0,0,
20200410,WA,11080,117241,,642,,191,,,,,C,"Fri, 10 Apr 2020 03:00:00 GMT",2020-04-10T03:00:00Z,04/09 23:00,476,,2020-04-10T03:00:00Z,53,275,4028,128321,128321,4303,128321,17,0,a7cee376056474625a4410f5b8ff55333f8a4b67,0,0,0,0,0,
20200409,WA,10805,113213,,650,,191,,,,,A,"Thu, 09 Apr 2020 03:00:00 GMT",2020-04-09T03:00:00Z,04/08 23:00,459,,2020-04-09T03:00:00Z,53,287,4033,124018,124018,4320,124018,16,0,12263ac4d0322738b0cfc53b350cb7556aef61c3,0,0,0,0,0,
20200408,WA,10518,109180,,655,,186,,,,,A,"Wed, 08 Apr 2020 03:00:00 GMT",2020-04-08T03:00:00Z,04/07 23:00,443,,2020-04-08T03:00:00Z,53,282,4525,119698,119698,4807,119698,14,0,6cc68fd63442283c5a3cdfe50edc4e1d36eba542,0,0,0,0,0,
20200407,WA,10236,104655,,641,,190,,,,,A,"Tue, 07 Apr 2020 03:00:00 GMT",2020-04-07T03:00:00Z,04/06 23:00,429,,2020-04-07T03:00:00Z,53,263,4978,114891,114891,5241,114891,22,0,59ad40c7b36c5934d54faf3ca647f4e300a5f2cb,0,0,0,0,0,
20200406,WA,9973,99677,,638,,191,,,,,A,"Mon, 06 Apr 2020 03:00:00 GMT",2020-04-06T03:00:00Z,04/05 23:00,407,,2020-04-06T03:00:00Z,53,324,4821,109650,109650,5145,109650,21,0,7a353e3624d02a693d1e023d3c47a1fadc79e111,0,0,0,0,0,
20200405,WA,9649,94856,,581,,178,,,,,A,"Sun, 05 Apr 2020 03:00:00 GMT",2020-04-05T03:00:00Z,04/04 23:00,386,,2020-04-05T03:00:00Z,53,220,1737,104505,104505,1957,104505,21,0,8ac9d6052e88d3640eceeb39cabd42263ff2b89d,0,0,0,0,0,
20200404,WA,9429,93119,,574,,174,,,,,A,"Sat, 04 Apr 2020 03:00:00 GMT",2020-04-04T03:00:00Z,04/03 23:00,365,,2020-04-04T03:00:00Z,53,244,2375,102548,102548,2619,102548,27,0,f1523aff1fb2d17ede91d69653a11e637bd9a13d,0,0,0,0,0,
20200403,WA,9185,90744,,,,,,,,,A,"Fri, 03 Apr 2020 03:00:00 GMT",2020-04-03T03:00:00Z,04/02 23:00,338,,2020-04-03T03:00:00Z,53,281,4574,99929,99929,4855,99929,28,0,dd23600dad7034e4bca26006a3d71155d5838d9d,0,0,0,0,0,
20200402,WA,8904,86170,,,,,,,,,A,"Thu, 02 Apr 2020 03:00:00 GMT",2020-04-02T03:00:00Z,04/01 23:00,310,,2020-04-02T03:00:00Z,53,330,4584,95074,95074,4914,95074,28,0,de2b1a6285ead0c4277884719e3803ca7b54e5d3,0,0,0,0,0,
20200401,WA,8574,81586,,,,,,,,,A,"Wed, 01 Apr 2020 03:00:00 GMT",2020-04-01T03:00:00Z,03/31 23:00,282,,2020-04-01T03:00:00Z,53,436,4266,90160,90160,4702,90160,20,0,5a77d823e7ebe7fadee792519b0e2f7db4820934,0,0,0,0,0,
20200331,WA,8138,77320,,,,,,,,,A,"Tue, 31 Mar 2020 03:00:00 GMT",2020-03-31T03:00:00Z,03/30 23:00,262,,2020-03-31T03:00:00Z,53,307,4418,85458,85458,4725,85458,14,0,509a0ba77813ca1fe1c787f7ab85d7ae10f797e4,0,0,0,0,0,
20200330,WA,7831,72902,,,,,,,,,A,"Mon, 30 Mar 2020 03:00:00 GMT",2020-03-30T03:00:00Z,03/29 23:00,248,,2020-03-30T03:00:00Z,53,402,4752,80733,80733,5154,80733,11,0,1b69664ce70e1fb97e9f61486264c0e5a8c044bd,0,0,0,0,0,
20200329,WA,7429,68150,,,,,,,,,A,"Sun, 29 Mar 2020 03:00:00 GMT",2020-03-29T03:00:00Z,03/28 23:00,237,,2020-03-29T03:00:00Z,53,317,1519,75579,75579,1836,75579,17,0,8eda0def6005ad114c1a2e33f05d76bdb1989378,0,0,0,0,0,
20200328,WA,7112,66631,,,,,,,,,A,"Sat, 28 Mar 2020 03:00:00 GMT",2020-03-28T03:00:00Z,03/27 23:00,220,,2020-03-28T03:00:00Z,53,321,2283,73743,73743,2604,73743,21,0,5b74613d79bf4f575535e745766d96779a8c9cb8,0,0,0,0,0,
20200327,WA,6791,64348,,,,,,,,,A,"Fri, 27 Mar 2020 03:00:00 GMT",2020-03-27T03:00:00Z,03/26 23:00,199,,2020-03-27T03:00:00Z,53,377,3981,71139,71139,4358,71139,16,0,a6ff5c9c3cb9953f6b3520c319ed4eb4f9789f59,0,0,0,0,0,
20200326,WA,6414,60367,,,,,,,,,A,"Thu, 26 Mar 2020 03:00:00 GMT",2020-03-26T03:00:00Z,03/25 23:00,183,,2020-03-26T03:00:00Z,53,369,4106,66781,66781,4475,66781,24,0,914a1553691facc3459c537df79d54c61ce560ff,0,0,0,0,0,
20200325,WA,6045,56261,,,,,,,,,A,"Wed, 25 Mar 2020 03:00:00 GMT",2020-03-25T03:00:00Z,03/24 23:00,159,,2020-03-25T03:00:00Z,53,405,4596,62306,62306,5001,62306,13,0,8a81420f218bc2bf837c301f14c8293327be0176,0,0,0,0,0,
20200324,WA,5640,51665,,,,,,,,,A,"Tue, 24 Mar 2020 03:00:00 GMT",2020-03-24T03:00:00Z,03/23 23:00,146,,2020-03-24T03:00:00Z,53,354,4892,57305,57305,5246,57305,9,0,3bc42922cbeaa545374a7931209a4c692fb76ae9,0,0,0,0,0,
20200323,WA,5286,46773,,,,,,,,,A,"Mon, 23 Mar 2020 03:00:00 GMT",2020-03-23T03:00:00Z,03/22 23:00,137,,2020-03-23T03:00:00Z,53,448,4857,52059,52059,5305,52059,11,0,167b939ae535929225fe448c1e3906136a09d9fb,0,0,0,0,0,
20200322,WA,4838,41916,,,,,,,,,,"Sun, 22 Mar 2020 03:00:00 GMT",2020-03-22T03:00:00Z,03/21 23:00,126,,2020-03-22T03:00:00Z,53,283,1605,46754,46754,1888,46754,15,0,cc09ac2b63afa9b1969616d33204a9591e79b4fb,0,0,0,0,0,
20200321,WA,4555,40311,,,,,,,,,,"Sat, 21 Mar 2020 03:00:00 GMT",2020-03-21T03:00:00Z,03/20 23:00,111,,2020-03-21T03:00:00Z,53,285,2060,44866,44866,2345,44866,7,0,bbe9a399e775e03aaa8f8918f23f98ab748ab26b,0,0,0,0,0,
20200320,WA,4270,38251,,,,,,,,,,"Fri, 20 Mar 2020 03:00:00 GMT",2020-03-20T03:00:00Z,03/19 23:00,104,,2020-03-20T03:00:00Z,53,403,3663,42521,42521,4066,42521,12,0,a81fdb345090f7e85dd9adadd1b0fb41cafca480,0,0,0,0,0,
20200319,WA,3867,34588,,,,,,,,,,"Thu, 19 Mar 2020 03:00:00 GMT",2020-03-19T03:00:00Z,03/18 23:00,92,,2020-03-19T03:00:00Z,53,335,4216,38455,38455,4551,38455,10,0,399c8ab5b3b7779363ead649df1d5725f9f9d53c,0,0,0,0,0,
20200318,WA,3532,30372,,,,,,,,,,"Wed, 18 Mar 2020 03:00:00 GMT",2020-03-18T03:00:00Z,03/17 23:00,82,,2020-03-18T03:00:00Z,53,378,4364,33904,33904,4742,33904,4,0,1bac9037eb4311dd0a90def6a711cc8ae95abd35,0,0,0,0,0,
20200317,WA,3154,26008,,,,,,,,,,"Tue, 17 Mar 2020 03:00:00 GMT",2020-03-17T03:00:00Z,03/16 23:00,78,,2020-03-17T03:00:00Z,53,324,4317,29162,29162,4641,29162,9,0,ed32a1ea602fdeca2a67506ee5d8ad15a0f7a800,0,0,0,0,0,
20200316,WA,2830,21691,,,,,,,,,,"Mon, 16 Mar 2020 03:00:00 GMT",2020-03-16T03:00:00Z,03/15 23:00,69,,2020-03-16T03:00:00Z,53,368,4531,24521,24521,4899,24521,12,0,13f2dddaf0db753a7685afe999194be84557a8cf,0,0,0,0,0,
20200315,WA,2462,17160,,,,,,,,,,"Sun, 15 Mar 2020 03:00:00 GMT",2020-03-15T03:00:00Z,03/14 23:00,57,,2020-03-15T03:00:00Z,53,254,1436,19622,19622,1690,19622,6,0,627f4d13e3c9ff185a01f320ecf60e43f7b66875,0,0,0,0,0,
20200314,WA,2208,15724,,,,,,,,,,"Sat, 14 Mar 2020 03:00:00 GMT",2020-03-14T03:00:00Z,03/13 23:00,51,,2020-03-14T03:00:00Z,53,265,2069,17932,17932,2334,17932,4,0,6b3e3305c3dcacd46cbed7968cf29d632e204057,0,0,0,0,0,
20200313,WA,1943,13655,,,,,,,,,,"Fri, 13 Mar 2020 03:00:00 GMT",2020-03-13T03:00:00Z,03/12 23:00,47,,2020-03-13T03:00:00Z,53,297,3937,15598,15598,4234,15598,3,0,606b8190c674d66abf353d35c7279b6a70e919e7,0,0,0,0,0,
20200312,WA,1646,9718,,,,,,,,,,"Thu, 12 Mar 2020 03:00:00 GMT",2020-03-12T03:00:00Z,03/11 23:00,44,,2020-03-12T03:00:00Z,53,256,3508,11364,11364,3764,11364,4,0,af40cb19d5481eaa809ebedbfb03f2419904f474,0,0,0,0,0,
20200311,WA,1390,6210,,,,,,,,,,"Wed, 11 Mar 2020 03:00:00 GMT",2020-03-11T03:00:00Z,03/10 23:00,40,,2020-03-11T03:00:00Z,53,212,2054,7600,7600,2266,7600,3,0,4eda396195c4d50999389767e4a9d90d9560d16f,0,0,0,0,0,
20200310,WA,1178,4156,,,,,,,,,,"Tue, 10 Mar 2020 03:00:00 GMT",2020-03-10T03:00:00Z,03/09 23:00,37,,2020-03-10T03:00:00Z,53,216,1567,5334,5334,1783,5334,2,0,e9887052a972197bd14ffeb26b97f9f2ba411143,0,0,0,0,0,
20200309,WA,962,2589,,,,,,,,,,"Mon, 09 Mar 2020 03:00:00 GMT",2020-03-09T03:00:00Z,03/08 23:00,35,,2020-03-09T03:00:00Z,53,173,851,3551,3551,1024,3551,4,0,9d7d2759a2ff6ec036abdba80068be350bda360d,0,0,0,0,0,
20200308,WA,789,1738,60,,,,,,,,,"Sun, 08 Mar 2020 04:00:00 GMT",2020-03-08T04:00:00Z,03/07 23:00,31,,2020-03-08T04:00:00Z,53,153,370,2587,2527,523,2527,4,0,711443a7134ffe253b283666a854cede31ef17da,0,0,0,0,0,
20200307,WA,636,1368,66,,,,,,,,,"Sat, 07 Mar 2020 04:00:00 GMT",2020-03-07T04:00:00Z,03/06 23:00,27,,2020-03-07T04:00:00Z,53,99,305,2070,2004,404,2004,1,0,bb5e3ad3ca566675ef101dd3fb474a4479a716c9,0,0,0,0,0,
20200306,WA,537,1063,,,,,,,,,,"Fri, 06 Mar 2020 04:00:00 GMT",2020-03-06T04:00:00Z,03/05 23:00,26,,2020-03-06T04:00:00Z,53,81,394,1600,1600,475,1600,6,0,b78795a7500ec4e29962fef19eb40fe666dbfca6,0,0,0,0,0,
20200305,WA,456,669,,,,,,,,,,"Thu, 05 Mar 2020 04:00:00 GMT",2020-03-05T04:00:00Z,03/04 23:00,20,,2020-03-05T04:00:00Z,53,105,256,1125,1125,361,1125,4,0,9d4bac718001b62931a6a8355a3f519d2292b170,0,0,0,0,0,
20200304,WA,351,413,,,,,,,,,,"Wed, 04 Mar 2020 04:00:00 GMT",2020-03-04T04:00:00Z,03/03 23:00,16,,2020-03-04T04:00:00Z,53,93,151,764,764,244,764,2,0,818ed333dcafb9410649e138b4246a552c8437ce,0,0,0,0,0,
20200303,WA,258,262,,,,,,,,,,"Tue, 03 Mar 2020 04:00:00 GMT",2020-03-03T04:00:00Z,03/02 23:00,14,,2020-03-03T04:00:00Z,53,84,140,520,520,224,520,3,0,7781f3f2d3b10feffe0106758440d5df3ece98a0,0,0,0,0,0,
20200302,WA,174,122,,,,,,,,,,"Mon, 02 Mar 2020 04:00:00 GMT",2020-03-02T04:00:00Z,03/01 23:00,11,,2020-03-02T04:00:00Z,53,72,108,296,296,180,296,3,0,4e658da3a59409e7aaf7c8440943b2dcad0f0006,0,0,0,0,0,
20200301,WA,102,14,,,,,,,,,,"Sun, 01 Mar 2020 04:00:00 GMT",2020-03-01T04:00:00Z,02/29 23:00,8,,2020-03-01T04:00:00Z,53,78,-3,116,116,75,116,3,0,0e908ebf1c888010f72647f557dcfb5a9ad99c4b,0,0,0,0,0,
20200229,WA,24,17,,,,,,,,,,"Sat, 29 Feb 2020 04:00:00 GMT",2020-02-29T04:00:00Z,02/28 23:00,5,,2020-02-29T04:00:00Z,53,15,17,41,41,32,41,1,0,8fecf509e46afcc77ede1451f9f2954cb13d3fcf,0,0,0,0,0,
20200228,WA,9,,,,,,,,,,,,,,4,,,53,7,0,9,9,7,9,2,0,5ac2cc32f64ed2b87fa8daef47cd50f37aa4361c,0,0,0,0,0,
20200227,WA,2,,,,,,,,,,,,,,2,,,53,0,0,2,2,0,2,0,0,e32b66f69e6796f27350b5aea1add5a3caa02780,0,0,0,0,0,
20200226,WA,2,,,,,,,,,,,,,,2,,,53,0,0,2,2,0,2,2,0,adfd4d6ba158c91578be070208aba68ee25446b1,0,0,0,0,0,
20200225,WA,2,,,,,,,,,,,,,,,,,53,0,0,2,2,0,2,0,0,18efcf1d60f13f2fb333ceaff2066096aa1e1f1d,0,0,0,0,0,
20200224,WA,2,,,,,,,,,,,,,,,,,53,0,0,2,2,0,2,0,0,adf4760aa4e781d9835b345c48fb7e2e39650153,0,0,0,0,0,
20200223,WA,2,,,,,,,,,,,,,,,,,53,0,0,2,2,0,2,0,0,d563e23adbb04b247bc063cfe4cfe25e3910b21c,0,0,0,0,0,
