date,state,positive,negative,pending,hospitalizedCurrently,hospitalizedCumulative,inIcuCurrently,inIcuCumulative,onVentilatorCurrently,onVentilatorCumulative,recovered,dataQualityGrade,lastUpdateEt,dateModified,checkTimeEt,death,hospitalized,dateChecked,totalTestsViral,positiveTestsViral,negativeTestsViral,positiveCasesViral,fips,positiveIncrease,negativeIncrease,total,totalTestResults,totalTestResultsIncrease,posNeg,deathIncrease,hospitalizedIncrease,hash,commercialScore,negativeRegularScore,negativeScore,positiveScore,score,grade
20200622,ID,4006,68962,,,283,,101,,,3305,A,6/20/2020 00:00,Invalid DateTime,Invalid DateTime,89,283,Invalid DateTime,72547,,,3585,16,0,0,72968,72968,0,72968,0,0,4489a533620b39bc4f8227cd0776e87882adf791,0,0,0,0,0,
20200621,ID,4006,68962,,,283,,101,,,3305,A,6/19/2020 23:00,Invalid DateTime,Invalid DateTime,89,283,Invalid DateTime,72547,,,3585,16,135,1637,72968,72968,1772,72968,0,4,4f35268d15900d410f78872bd9d3ed3e0a3c59d5,0,0,0,0,0,
20200620,ID,3871,67325,,,279,,101,,,3183,A,6/19/2020 18:00,Invalid DateTime,Invalid DateTime,89,279,Invalid DateTime,70791,,,3466,16,128,1523,71196,71196,1651,71196,0,1,80f8e614fc71aea3ec8d1f6fd56218656661a13f,0,0,0,0,0,
20200619,ID,3743,65802,,,278,,101,,,3088,A,6/18/2020 18:00,Invalid DateTime,Invalid DateTime,89,278,Invalid DateTime,69156,,,3354,16,111,1422,69545,69545,1533,69545,1,3,1a1083fbd48df7292447f5f4b04959b608c47b67,0,0,0,0,0,
20200618,ID,3632,64380,,,275,,101,,,3013,A,6/17/2020 18:00,Invalid DateTime,Invalid DateTime,88,275,Invalid DateTime,67638,,,3258,16,92,1136,68012,68012,1228,68012,0,0,7815d7d90742b36c2c56c52d78e163d14fe4631d,0,0,0,0,0,
20200617,ID,3540,63244,,,275,,101,,,2921,A,6/16/2020 18:00,Invalid DateTime,Invalid DateTime,88,275,Invalid DateTime,66441,,,3197,16,78,1059,66784,66784,1137,66784,0,5,7b90da79735c2dd2d4e43c18eeb8d0c79315e167,0,0,0,0,0,
20200616,ID,3462,62185,,,270,,100,,,2877,A,6/15/2020 18:00,Invalid DateTime,Invalid DateTime,88,270,Invalid DateTime,65306,,,3121,16,63,2604,65647,65647,2667,65647,1,4,8de6112823865f3ae54d79400cd97ab483f9d25d,0,0,0,0,0,
20200615,ID,3399,59581,,,266,,98,,,2837,A,6/13/2020 18:00,Invalid DateTime,Invalid DateTime,87,266,Invalid DateTime,62642,,,3061,16,0,0,62980,62980,0,62980,0,0,5cef0023217ed8ae112445f71b2b819d09f90819,0,0,0,0,0,
20200614,ID,3399,59581,,,266,,98,,,2837,A,6/13/2020 18:00,Invalid DateTime,Invalid DateTime,87,266,Invalid DateTime,62642,,,3061,16,46,276,62980,62980,322,62980,0,1,c173c93c41c244593b27363ad7057e7efdb84b23,0,0,0,0,0,
20200613,ID,3353,59305,,,265,,98,,,2776,A,6/12/2020 18:00,Invalid DateTime,Invalid DateTime,87,265,Invalid DateTime,62328,,,3023,16,51,1175,62658,62658,1226,62658,1,0,e2b8f8c976f111c7d2f46750a26b5d533ba34abf,0,0,0,0,0,
20200612,ID,3302,58130,,,265,,98,,,2684,A,6/11/2020 18:00,Invalid DateTime,Invalid DateTime,86,265,Invalid DateTime,61114,,,2984,16,42,1275,61432,61432,1317,61432,1,3,77852bfc2918aeeb0b6e1ec0bd8b2083234dd923,0,0,0,0,0,
20200611,ID,3260,56855,,,262,,99,,,2628,A,6/10/2020 18:00,Invalid DateTime,Invalid DateTime,85,262,Invalid DateTime,59802,,,2947,16,40,1023,60115,60115,1063,60115,0,0,0966dcc6ecf6dab9f9cda2b46cf64d1164652592,0,0,0,0,0,
20200610,ID,3220,55832,,,262,,99,,,2554,A,6/09/2020 18:00,Invalid DateTime,Invalid DateTime,85,262,Invalid DateTime,58746,,,2914,16,31,1344,59052,59052,1375,59052,2,2,02bb0401b37ce9c3d8b113ae5aae0392016fa3dc,0,0,0,0,0,
20200609,ID,3189,54488,,,260,,99,,,2509,A,6/08/2020 18:00,Invalid DateTime,Invalid DateTime,83,260,Invalid DateTime,57376,,,2888,16,50,1586,57677,57677,1636,57677,0,0,bc169e506df0220b746b6ecdae844dd46c9a98c0,0,0,0,0,0,
20200608,ID,3139,52902,,,260,,99,,,2461,A,6/06/2020 18:00,Invalid DateTime,Invalid DateTime,83,260,Invalid DateTime,55742,,,2840,16,0,0,56041,56041,0,56041,0,0,3518dc11bb7bbae80937d70ed66fb3c40d695b31,0,0,0,0,0,
20200607,ID,3139,52902,,,260,,99,,,2461,A,6/06/2020 18:00,Invalid DateTime,Invalid DateTime,83,260,Invalid DateTime,55742,,,2840,16,28,774,56041,56041,802,56041,0,3,2a94bf0bce39eccbd4c51cd64391b60a4bbc07ff,0,0,0,0,0,
20200606,ID,3111,52128,,,257,,98,,,2408,A,6/05/2020 18:00,Invalid DateTime,Invalid DateTime,83,257,Invalid DateTime,54949,,,2821,16,57,1558,55239,55239,1615,55239,0,2,7af92f3e1dc92337316fe29c0cfb09ff0582ab43,0,0,0,0,0,
20200605,ID,3054,50570,,,255,,98,,,2362,A,6/04/2020 18:00,Invalid DateTime,Invalid DateTime,83,255,Invalid DateTime,53333,,,2763,16,64,3755,53624,53624,3819,53624,0,2,5fb1037cb0ac8fd2e02e91dfde1c211ad9abab45,0,0,0,0,0,
20200604,ID,2990,46815,,,253,,98,,,2311,A,6/03/2020 18:00,Invalid DateTime,Invalid DateTime,83,253,Invalid DateTime,49524,,,2709,16,57,806,49805,49805,863,49805,0,2,1e8fa13530acec69107558d672956ca0eba27388,0,0,0,0,0,
20200603,ID,2933,46009,,,251,,98,,,2282,A,6/02/2020 18:00,Invalid DateTime,Invalid DateTime,83,251,Invalid DateTime,48669,,,2660,16,27,782,48942,48942,809,48942,0,4,89c9363842d65a64ec6a40da47a1d27e33d5c676,0,0,0,0,0,
20200602,ID,2906,45227,,,247,,98,,,2266,A,6/01/2020 18:00,Invalid DateTime,Invalid DateTime,83,247,Invalid DateTime,47870,,,2643,16,67,1369,48133,48133,1436,48133,1,5,273cc1e3782f9e6cd49afad5dc5e2cece667c1cc,0,0,0,0,0,
20200601,ID,2839,43858,,,242,,96,,,2248,A,5/30/2020 18:00,Invalid DateTime,Invalid DateTime,82,242,Invalid DateTime,46436,,,2578,16,0,0,46697,46697,0,46697,0,0,96aee44644e15996e5559a5116afd4a50c1747bf,0,0,0,0,0,
20200531,ID,2839,43858,,,242,,96,,,2248,A,5/30/2020 18:00,Invalid DateTime,Invalid DateTime,82,242,Invalid DateTime,46436,,,2578,16,36,1237,46697,46697,1273,46697,0,2,5a6a9398212360830f9d5b82199860966b64ea7f,0,0,0,0,0,
20200530,ID,2803,42621,,,240,,96,,,2225,A,5/29/2020 18:00,Invalid DateTime,Invalid DateTime,82,240,Invalid DateTime,45172,,,2551,16,34,629,45424,45424,663,45424,0,2,c011b0ced961acd8b5f102ade70c3716d638ac19,0,0,0,0,0,
20200529,ID,2769,41992,,,238,,96,,,2195,A,5/28/2020 18:00,Invalid DateTime,Invalid DateTime,82,238,Invalid DateTime,44511,,,2519,16,38,848,44761,44761,886,44761,0,4,279c3d43877f5636d390a4026a3eaa63f2014a05,0,0,0,0,0,
20200528,ID,2731,41144,,,234,,95,,,2185,A,5/27/2020 18:00,Invalid DateTime,Invalid DateTime,82,234,Invalid DateTime,43629,,,2485,16,32,826,43875,43875,858,43875,1,3,5701f8b1c6e0b986b8559427deef7c961d3ae1b0,0,0,0,0,0,
20200527,ID,2699,40318,,,231,,95,,,2100,A,5/26/2020 18:00,Invalid DateTime,Invalid DateTime,81,231,Invalid DateTime,42776,,,2458,16,73,1538,43017,43017,1611,43017,2,6,d2f1d4f5808cc39b3253ab164b71c4e1872e0d74,0,0,0,0,0,
20200526,ID,2626,38780,,,225,,94,,,1755,A,5/23/2020 18:00,Invalid DateTime,Invalid DateTime,79,225,Invalid DateTime,41167,,,2387,16,0,0,41406,41406,0,41406,0,0,476b5a50415ffa4fd4e2fd06e8494a8a3cecf8e5,0,0,0,0,0,
20200525,ID,2626,38780,,,225,,94,,,1755,A,5/23/2020 18:00,Invalid DateTime,Invalid DateTime,79,225,Invalid DateTime,41167,,,2387,16,0,0,41406,41406,0,41406,0,0,b9afa077bee39fb06a5a26925cc8ab2cad97f786,0,0,0,0,0,
20200524,ID,2626,38780,,,225,,94,,,1755,A,5/23/2020 18:00,Invalid DateTime,Invalid DateTime,79,225,Invalid DateTime,41167,,,2387,16,31,766,41406,41406,797,41406,0,0,5dbd37f6edd0faf30cd09dfb6715109205669864,0,0,0,0,0,
20200523,ID,2595,38014,,,225,,94,,,1735,A,5/22/2020 18:00,Invalid DateTime,Invalid DateTime,79,225,Invalid DateTime,40370,,,2356,16,61,953,40609,40609,1014,40609,2,2,dd7d41750c4c2bd92d09b34485bcc44c3dde51b9,0,0,0,0,0,
20200522,ID,2534,37061,,,223,,92,,,1720,A,5/21/2020 18:00,Invalid DateTime,Invalid DateTime,77,223,Invalid DateTime,39362,,,2301,16,28,679,39595,39595,707,39595,0,2,5728a88d87fd26df500804c0b254b3d31ef50d85,0,0,0,0,0,
20200521,ID,2506,36382,,,221,,91,,,1688,B,5/20/2020 18:00,Invalid DateTime,Invalid DateTime,77,221,Invalid DateTime,38660,,,2278,16,30,291,38888,38888,321,38888,0,6,e5e1f6d142460663d3e91541aab80fa35e2c713b,0,0,0,0,0,
20200520,ID,2476,36091,,,215,,89,,,1668,B,5/19/2020 18:00,Invalid DateTime,Invalid DateTime,77,215,Invalid DateTime,38344,,,2253,16,21,477,38567,38567,498,38567,3,2,fe91c7d7bd53a8c1db0856112df95e276c577a4b,0,0,0,0,0,
20200519,ID,2455,35614,,,213,,89,,,1649,B,5/18/2020 18:00,Invalid DateTime,Invalid DateTime,74,213,Invalid DateTime,37847,,,2233,16,36,1361,38069,38069,1397,38069,1,0,52bbd51b399d7b5717c2b01f8e687aa2dceaec29,0,0,0,0,0,
20200518,ID,2419,34253,,,213,,89,,,1612,B,5/16/2020 18:00,Invalid DateTime,Invalid DateTime,73,213,Invalid DateTime,36456,,,2203,16,0,0,36672,36672,0,36672,0,0,33d88439b28f88dd96599459732141a8c3f3c709,0,0,0,0,0,
20200517,ID,2419,34253,,,213,,89,,,1612,B,5/16/2020 18:00,Invalid DateTime,Invalid DateTime,73,213,Invalid DateTime,36456,,,2203,16,30,954,36672,36672,984,36672,0,0,98f23c1157590710cf5124d918482d654bbb348c,0,0,0,0,0,
20200516,ID,2389,33299,,,213,,89,,,1588,B,5/15/2020 18:00,Invalid DateTime,Invalid DateTime,73,213,Invalid DateTime,35485,,,2186,16,38,905,35688,35688,943,35688,1,1,fed423e7143b8fbd838a8360f2b5971b883f7674,0,0,0,0,0,
20200515,ID,2351,32394,,,212,,89,,,1573,B,5/14/2020 18:00,Invalid DateTime,Invalid DateTime,72,212,Invalid DateTime,34546,,,2152,16,27,964,34745,34745,991,34745,3,0,6a1a484685664a1f3edd9eae72a2d5832a4db9f1,0,0,0,0,0,
20200514,ID,2324,31430,,,212,,88,,,1557,B,5/13/2020 18:00,Invalid DateTime,Invalid DateTime,69,212,Invalid DateTime,33556,,,2126,16,31,595,33754,33754,626,33754,0,-2,9d8e9c8534a277d0b1e9af0ae76a6f97f1faad18,0,0,0,0,0,
20200513,ID,2293,30835,,,214,,88,,,1536,B,5/12/2020 18:00,Invalid DateTime,Invalid DateTime,69,214,Invalid DateTime,32934,,,2099,16,33,390,33128,33128,423,33128,-1,4,4ffbbfe83852763213bb346abda0e138ac98732e,0,0,0,0,0,
20200512,ID,2260,30445,,,210,,87,,,1508,B,5/11/2020 18:00,Invalid DateTime,Invalid DateTime,70,210,Invalid DateTime,32518,,,2073,16,30,533,32705,32705,563,32705,3,3,c46411636cb92ae25607aa3d6badeda56eaa3990,0,0,0,0,0,
20200511,ID,2230,29912,,,207,,87,,,1473,B,5/09/2020 18:00,Invalid DateTime,Invalid DateTime,67,207,Invalid DateTime,31961,,,2049,16,0,0,32142,32142,0,32142,0,0,bf271558b233ba1b9341cdc8ad914344aa43df34,0,0,0,0,0,
20200510,ID,2230,29912,,,207,,87,,,1473,B,5/09/2020 18:00,Invalid DateTime,Invalid DateTime,67,207,Invalid DateTime,31961,,,2049,16,25,311,32142,32142,336,32142,0,1,04fbbdd0458999027683d99cab7ea9a3194ab144,0,0,0,0,0,
20200509,ID,2205,29601,,,206,,86,,,1442,B,5/08/2020 18:00,Invalid DateTime,Invalid DateTime,67,206,Invalid DateTime,31628,,,2027,16,27,509,31806,31806,536,31806,0,0,5a51fad0ce1eb1978f13bc783add6e9ad522693e,0,0,0,0,0,
20200508,ID,2178,29092,,,206,,86,,,1420,B,5/07/2020 18:00,Invalid DateTime,Invalid DateTime,67,206,Invalid DateTime,31099,,,2007,16,20,360,31270,31270,380,31270,1,1,4684eaa359123b731bb17787c47b9599024b7096,0,0,0,0,0,
20200507,ID,2158,28732,,,205,,86,,,1399,B,5/06/2020 18:00,Invalid DateTime,Invalid DateTime,66,205,Invalid DateTime,30718,,,1986,16,31,314,30890,30890,345,30890,1,2,f76cbc0ea304cd435a59803abc732e070af6bccd,0,0,0,0,0,
20200506,ID,2127,28418,,,203,,84,,,1379,C,5/04/2020 18:00,Invalid DateTime,Invalid DateTime,65,203,Invalid DateTime,30375,,,1957,16,21,216,30545,30545,237,30545,1,2,86ae9283df728f6852753d0af01781fabde25482,0,0,0,0,0,
20200505,ID,2106,28202,,,201,,83,,,1358,C,5/03/2020 18:00,Invalid DateTime,Invalid DateTime,64,201,Invalid DateTime,30146,,,1944,16,45,456,30308,30308,501,30308,0,1,0bc3a1159ffd910619ae2bd4ce7ffecf265c6ab5,0,0,0,0,0,
20200504,ID,2061,27746,,,200,,83,,,1267,C,5/02/2020 18:00,Invalid DateTime,Invalid DateTime,64,200,Invalid DateTime,29651,,,1905,16,0,0,29807,29807,0,29807,1,0,2a868a5547640b9401b9d56f2ac18426f9d3ca6c,0,0,0,0,0,
20200503,ID,2061,27746,,,200,,83,,,1267,C,5/02/2020 18:00,Invalid DateTime,Invalid DateTime,63,200,Invalid DateTime,29651,,,1905,16,26,291,29807,29807,317,29807,0,22,a7d3d3ce1cab5c757aff09c56078403cb718a3e7,0,0,0,0,0,
20200502,ID,2035,27455,,,178,,76,,,1215,C,5/01/2020 18:00,Invalid DateTime,Invalid DateTime,63,178,Invalid DateTime,29335,,,1880,16,20,245,29490,29490,265,29490,0,0,16fcf0dc468fd2f3ae42472237882e140bf040d2,0,0,0,0,0,
20200501,ID,2015,27210,,,178,,75,,,1175,C,4/30/2020 18:00,Invalid DateTime,Invalid DateTime,63,178,Invalid DateTime,29070,,,1860,16,31,348,29225,29225,379,29225,3,3,64cd547bea5df6562f069924c175e12be461c89a,0,0,0,0,0,
20200430,ID,1984,26862,,,175,,74,,,1121,C,4/29/2020 18:00,Invalid DateTime,Invalid DateTime,60,175,Invalid DateTime,28693,,,1831,16,32,432,28846,28846,464,28846,0,2,a82971220ad89ff5ed7d6a63ef879066f400b5f3,0,0,0,0,0,
20200429,ID,1952,26430,,,173,,73,,,1087,C,4/28/2020 18:00,Invalid DateTime,Invalid DateTime,60,173,Invalid DateTime,28240,,,1810,16,35,8295,28382,28382,8330,28382,2,1,ed922d125fd12a551d3fa608525cd8734c480adc,0,0,0,0,0,
20200428,ID,1917,18135,,,172,,73,,,1039,C,4/27/2020 18:00,Invalid DateTime,Invalid DateTime,58,172,Invalid DateTime,20052,,,,16,20,8,20052,20052,28,20052,2,3,1ca0eba8fbef16dfc8c19e1af3a710902621ff34,0,0,0,0,0,
20200427,ID,1897,18127,,,169,,71,,,983,C,4/26/2020 18:00,Invalid DateTime,Invalid DateTime,56,169,Invalid DateTime,20024,,,,16,10,516,20024,20024,526,20024,0,0,3eed62f52bc3fa63187cf6396440940271ed34f0,0,0,0,0,0,
20200426,ID,1887,17611,,,169,,72,,,938,C,4/25/2020 18:00,Invalid DateTime,Invalid DateTime,56,169,Invalid DateTime,19498,,,,16,17,0,19498,19498,17,19498,2,1,20bf503b0c6353b82a0992564988d4d1b998fb04,0,0,0,0,0,
20200425,ID,1870,17611,,,168,,71,,,867,C,4/24/2020 18:00,Invalid DateTime,Invalid DateTime,54,168,Invalid DateTime,19481,,,,16,34,0,19481,19481,34,19481,0,2,274110014b0cb27764e2a4afca39ce8f863c345a,0,0,0,0,0,
20200424,ID,1836,17611,,,166,,63,,,822,A,4/24/2020 18:00,Invalid DateTime,Invalid DateTime,54,166,Invalid DateTime,19447,,,,16,34,241,19447,19447,275,19447,0,4,24e41693417187764ed88851a3c01faa131d91a3,0,0,0,0,0,
20200423,ID,1802,17370,,,162,,60,,,767,A,4/23/2020 18:00,Invalid DateTime,Invalid DateTime,54,162,Invalid DateTime,19172,,,,16,36,966,19172,19172,1002,19172,3,4,814fd921b507442f974e1728566800d0ee78ff9c,0,0,0,0,0,
20200422,ID,1766,16404,,,158,,58,,,710,A,4/22/2020 18:00,Invalid DateTime,Invalid DateTime,51,158,Invalid DateTime,18170,,,,16,30,333,18170,18170,363,18170,3,1,946a2fb2a5c72d4cea70f1b3e8f8dd052a87d934,0,0,0,0,0,
20200421,ID,1736,16071,,,157,,58,,,660,A,4/21/2020 18:00,Invalid DateTime,Invalid DateTime,48,157,Invalid DateTime,17807,,,,16,64,298,17807,17807,362,17807,3,6,4861eb4dae875f4254311df5476af44eade5ec0a,0,0,0,0,0,
20200420,ID,1672,15773,,,151,,53,,,585,A,4/19/2020 18:00,Invalid DateTime,Invalid DateTime,45,151,Invalid DateTime,17445,,,,16,4,0,17445,17445,4,17445,1,0,74daa8c65a154236173b13b280cff7120decfa6f,0,0,0,0,0,
20200419,ID,1668,15773,,,151,,53,,,520,A,4/19/2020 18:00,Invalid DateTime,Invalid DateTime,44,151,Invalid DateTime,17441,,,,16,13,481,17441,17441,494,17441,1,0,e181ebb91cefc236f50e42a5fe18c19d9a0edc23,0,0,0,0,0,
20200418,ID,1655,15292,,,151,,53,,,453,A,4/17/2020 18:00,Invalid DateTime,Invalid DateTime,43,151,Invalid DateTime,16947,,,,16,46,249,16947,16947,295,16947,2,3,31fabf56205b36c0bbdd21f2386f21e64d644150,0,0,0,0,0,
20200417,ID,1609,15043,,,148,,51,,,390,A,4/17/2020 18:00,Invalid DateTime,Invalid DateTime,41,148,Invalid DateTime,16652,,,,16,22,388,16652,16652,410,16652,0,5,842e1f62cfe000c48078fbdebd289a11664b455a,0,0,0,0,0,
20200416,ID,1587,14655,,,143,,46,,,,A,4/16/2020 18:00,Invalid DateTime,Invalid DateTime,41,143,Invalid DateTime,16242,,,,16,123,721,16242,16242,844,16242,2,2,040a35f4dd045d23368079eb6689c152afbe3313,0,0,0,0,0,
20200415,ID,1464,13934,,,141,,43,,,,A,4/14/2020 18:00,Invalid DateTime,Invalid DateTime,39,141,Invalid DateTime,15398,,,,16,11,273,15398,15398,284,15398,6,6,7d7e2c92b35d582dc63703fda1e99d9796b55f95,0,0,0,0,0,
20200414,ID,1453,13661,,,135,,38,,,,A,4/14/2020 18:00,Invalid DateTime,Invalid DateTime,33,135,Invalid DateTime,15114,,,,16,27,206,15114,15114,233,15114,6,3,e1bef36ec4f5bcace3ca87eca50a3695f26a04c8,0,0,0,0,0,
20200413,ID,1426,13455,,,132,,38,,,,A,4/13/2020 18:00,Invalid DateTime,Invalid DateTime,27,132,Invalid DateTime,14881,,,,16,19,554,14881,14881,573,14881,0,1,43099e74d1ef7c6be81b95d5d4797fda122e6e66,0,0,0,0,0,
20200412,ID,1407,12901,,,131,,38,,,,A,4/11/2020 18:00,Invalid DateTime,Invalid DateTime,27,131,Invalid DateTime,14308,,,,16,11,533,14308,14308,544,14308,2,3,a52408e31486794c8de3d17a1a1599e1973ebbd6,0,0,0,0,0,
20200411,ID,1396,12368,,,128,,35,,,,A,4/10/2020 18:00,Invalid DateTime,Invalid DateTime,25,128,Invalid DateTime,13764,,,,16,43,627,13764,13764,670,13764,1,1,ab08b11b627604e841fb93a7f7621f219d9bbd76,0,0,0,0,0,
20200410,ID,1353,11741,,,127,,33,,,,A,4/09/2020 18:00,Invalid DateTime,Invalid DateTime,24,127,Invalid DateTime,13094,,,,16,121,442,13094,13094,563,13094,6,14,bba9443cfee831b2bf9fe6d54eb4f00408d4c4d3,0,0,0,0,0,
20200409,ID,1232,11299,,,113,,29,,,,A,4/08/2020 18:00,Invalid DateTime,Invalid DateTime,18,113,Invalid DateTime,12531,,,,16,22,611,12531,12531,633,12531,3,20,989e47f0eac283fd147973351426b93662666f20,0,0,0,0,0,
20200408,ID,1210,10688,,,93,,24,,,,A,4/07/2020 18:00,Invalid DateTime,Invalid DateTime,15,93,Invalid DateTime,11898,,,,16,40,612,11898,11898,652,11898,2,10,072fd16c9a7e0c4809d7da70b61ea4c635fabf31,0,0,0,0,0,
20200407,ID,1170,10076,,,83,,21,,,,A,4/06/2020 18:00,Invalid DateTime,Invalid DateTime,13,83,Invalid DateTime,11246,,,,16,69,182,11246,11246,251,11246,3,6,c2bff88274e6b75b25e2990c6fed6f18bc63f63e,0,0,0,0,0,
20200406,ID,1101,9894,,,77,,16,,,,A,4/05/2020 18:00,Invalid DateTime,Invalid DateTime,10,77,Invalid DateTime,10995,,,,16,24,710,10995,10995,734,10995,0,11,e9c1113f49c1ab6482fdf48d7df9d8da98ed87ef,0,0,0,0,0,
20200405,ID,1077,9184,,,66,,11,,,,A,4/04/2020 18:00,Invalid DateTime,Invalid DateTime,10,66,Invalid DateTime,10261,,,,16,64,1327,10261,10261,1391,10261,0,4,86ba38e5f9eb506ac5500c51d1612aa1f84139ec,0,0,0,0,0,
20200404,ID,1013,7857,,,62,,8,,,,A,4/03/2020 18:00,Invalid DateTime,Invalid DateTime,10,62,Invalid DateTime,8870,,,,16,122,803,8870,8870,925,8870,1,6,7ab935059d532ab26eba9bb1de663f350566d83d,0,0,0,0,0,
20200403,ID,891,7054,,,56,,7,,,,A,4/02/2020 18:00,Invalid DateTime,Invalid DateTime,9,56,Invalid DateTime,7945,,,,16,222,441,7945,7945,663,7945,0,7,cbc09c88729c1490f21f79af7a6484961db12961,0,0,0,0,0,
20200402,ID,669,6613,,,49,,7,,,,A,4/01/2020 18:00,Invalid DateTime,Invalid DateTime,9,49,Invalid DateTime,7282,,,,16,144,537,7282,7282,681,7282,0,3,1f39604aec71c74c69ebd66ce3c0a4c8b825fdcc,0,0,0,0,0,
20200401,ID,525,6076,,,46,,7,,,,A,3/31/2020 18:00,Invalid DateTime,Invalid DateTime,9,46,Invalid DateTime,6601,,,,16,110,779,6601,6601,889,6601,2,1,3145eea1fd0a64a13c4e537f48c62fdd4316f351,0,0,0,0,0,
20200331,ID,415,5297,,,45,,6,,,,A,3/30/2020 18:00,Invalid DateTime,Invalid DateTime,7,45,Invalid DateTime,5712,,,,16,105,901,5712,5712,1006,5712,1,6,fe7ef0877bdfeb5fc1376958e06559b33eb8fd53,0,0,0,0,0,
20200330,ID,310,4396,,,39,,,,,,A,3/29/2020 18:00,Invalid DateTime,Invalid DateTime,6,39,Invalid DateTime,4706,,,,16,49,375,4706,4706,424,4706,1,3,041d7415be9ef2d72d1fca6d759af05a5ad6536d,0,0,0,0,0,
20200329,ID,261,4021,,,36,,,,,,A,3/28/2020 17:55,Invalid DateTime,Invalid DateTime,5,36,Invalid DateTime,4282,,,,16,31,679,4282,4282,710,4282,1,11,e1e7cdd66115f3ebd4b8891aacdcff8b362e30ed,0,0,0,0,0,
20200328,ID,230,3342,,,25,,,,,,A,3/27/2020 18:00,Invalid DateTime,Invalid DateTime,4,25,Invalid DateTime,3572,,,,16,41,674,3572,3572,715,3572,1,25,c11b976b3b43f3306def892bf0ec5df0e4b77f97,0,0,0,0,0,
20200327,ID,189,2668,,,,,,,,,A,3/26/2020 19:00,Invalid DateTime,Invalid DateTime,3,,Invalid DateTime,2857,,,,16,66,603,2857,2857,669,2857,3,0,753d2220b0533af0d9d60fddf2ad833db1971698,0,0,0,0,0,
20200326,ID,123,2065,,,,,,,,,A,3/25/2020 18:00,Invalid DateTime,Invalid DateTime,0,,Invalid DateTime,2188,,,,16,50,178,2188,2188,228,2188,0,0,d41e9388960146d7d04c5fbaaca4a931c9498f27,0,0,0,0,0,
20200325,ID,73,1887,,,,,,,,,A,3/24/2020 18:00,Invalid DateTime,Invalid DateTime,0,,Invalid DateTime,1960,,,,16,23,0,1960,1960,23,1960,0,0,e62f057ab8853fb831c28ed5191a40a5a21a0d93,0,0,0,0,0,
20200324,ID,50,1887,,,,,,,,,A,3/23/2020 18:00,Invalid DateTime,Invalid DateTime,0,,Invalid DateTime,1937,,,,16,3,578,1937,1937,581,1937,0,0,971a6b5852eaebc186193ebb4ca590402a9a8f19,0,0,0,0,0,
20200323,ID,47,1309,,,,,,,,,A,3/22/2020 18:00,Invalid DateTime,Invalid DateTime,0,,Invalid DateTime,1356,,,,16,5,134,1356,1356,139,1356,0,0,1dd2aa262425a11693841bc439c0b8cdef1f9977,0,0,0,0,0,
20200322,ID,42,1175,,,,,,,,,,3/21/2020 18:55,Invalid DateTime,Invalid DateTime,0,,Invalid DateTime,1217,,,,16,11,295,1217,1217,306,1217,0,0,48f9d31ccf697f7b7e0de9741395109dd724ed4e,0,0,0,0,0,
20200321,ID,31,880,,,,,,,,,,3/20/2020 18:00,Invalid DateTime,Invalid DateTime,,,Invalid DateTime,911,,,,16,8,290,911,911,298,911,0,0,46c2aaa1adb33b36dc5bd0eec1628791444b9bd3,0,0,0,0,0,
20200320,ID,23,590,,,,,,,,,,3/19/2020 18:00,Invalid DateTime,Invalid DateTime,,,Invalid DateTime,613,,,,16,12,131,613,613,143,613,0,0,f0a0cde95b6d2336a6f28352826e82d70b74684d,0,0,0,0,0,
20200319,ID,11,459,,,,,,,,,,3/18/2020 09:30,Invalid DateTime,Invalid DateTime,,,Invalid DateTime,470,,,,16,2,0,470,470,2,470,0,0,4f72a46cd79c35f81e2bad8a3fdd400f345b8d19,0,0,0,0,0,
20200318,ID,9,459,,,,,,,,,,3/18/2020 09:30,Invalid DateTime,Invalid DateTime,,,Invalid DateTime,468,,,,16,2,113,468,468,115,468,0,0,5bc89c42147de19b443b90f117104f47e85d6783,0,0,0,0,0,
20200317,ID,7,346,,,,,,,,,,3/17/2020 10:45,Invalid DateTime,Invalid DateTime,,,Invalid DateTime,353,,,,16,2,81,353,353,83,353,0,0,19d4717f61eef7b80920f42490a3545c7c5cf971,0,0,0,0,0,
20200316,ID,5,265,,,,,,,,,,3/16/2020 14:42,Invalid DateTime,Invalid DateTime,,,Invalid DateTime,270,,,,16,0,91,270,270,91,270,0,0,892759c10b9d21369ec570742336b159a9a7410c,0,0,0,0,0,
20200315,ID,5,174,,,,,,,,,,3/13/2020 21:45,Invalid DateTime,Invalid DateTime,,,Invalid DateTime,179,,,,16,3,0,179,179,3,179,0,0,486f90427e5ba6f0b61a518c79e9d5559f818caa,0,0,0,0,0,
20200314,ID,2,174,,,,,,,,,,3/13/2020 21:45,Invalid DateTime,Invalid DateTime,,,Invalid DateTime,176,,,,16,2,43,176,176,45,176,0,0,6ddb229708e5601043d0788c80ba2c1222273e1f,0,0,0,0,0,
20200313,ID,0,131,,,,,,,,,,3/13/2020 07:00,Invalid DateTime,Invalid DateTime,,,Invalid DateTime,131,,,,16,0,38,131,131,38,131,0,0,2ee0e930aa83a97352e79ecf7b9ba17bb9ffd2ac,0,0,0,0,0,
20200312,ID,0,93,,,,,,,,,,3/12/2020 08:45,Invalid DateTime,Invalid DateTime,,,Invalid DateTime,93,,,,16,0,26,93,93,26,93,0,0,504e9f62e1a698cd11b98485de27e756e2346d21,0,0,0,0,0,
20200311,ID,0,67,,,,,,,,,,,,,,,,67,,,,16,0,26,67,67,26,67,0,0,7e0a5603fc89df535f9972b8c6c023ef6d055e1b,0,0,0,0,0,
20200310,ID,0,41,,,,,,,,,,,,,,,,41,,,,16,0,0,41,41,0,41,0,0,1e6822f528f16e8e9468cdba6d69262392fca10a,0,0,0,0,0,
20200309,ID,0,41,,,,,,,,,,,,,,,,41,,,,16,0,14,41,41,14,41,0,0,1c48eb401cea2350fd969468453e9bd22865526e,0,0,0,0,0,
20200308,ID,0,27,,,,,,,,,,,,,,,,27,,,,16,0,0,27,27,0,27,0,0,60fe4fee3f3815282866366ba7e5ae81c72329a9,0,0,0,0,0,
20200307,ID,0,27,,,,,,,,,,,,,,,,27,,,,16,0,0,27,27,0,27,0,0,4fe7980959728ac8d93da6f7edd92dca79a9994d,0,0,0,0,0,
