date,state,positive,negative,pending,hospitalizedCurrently,hospitalizedCumulative,inIcuCurrently,inIcuCumulative,onVentilatorCurrently,onVentilatorCumulative,recovered,dataQualityGrade,lastUpdateEt,dateModified,checkTimeEt,death,hospitalized,dateChecked,totalTestsViral,positiveTestsViral,negativeTestsViral,positiveCasesViral,fips,positiveIncrease,negativeIncrease,total,totalTestResults,totalTestResultsIncrease,posNeg,deathIncrease,hospitalizedIncrease,hash,commercialScore,negativeRegularScore,negativeScore,positiveScore,score,grade
20200623,KS,12465,142548,,,1056,,342,,149,722,A,6/22/2020 10:00,Invalid DateTime,Invalid DateTime,259,1056,Invalid DateTime,,,,12465,20,0,0,155013,155013,0,155013,0,0,ec3366388d93cdb94aa0dcb76f370291ba731261,0,0,0,0,0,
20200622,KS,12465,142548,,,1056,,342,,149,722,A,6/22/2020 10:00,Invalid DateTime,Invalid DateTime,259,1056,Invalid DateTime,,,,12465,20,406,6958,155013,155013,7364,155013,5,21,d7d89a7014e084d4cc9a3040ae4b9aafa1fecdd3,0,0,0,0,0,
20200621,KS,12059,135590,,,1035,,338,,146,715,A,6/19/2020 09:00,Invalid DateTime,Invalid DateTime,254,1035,Invalid DateTime,,,,12059,20,0,0,147649,147649,0,147649,0,0,3518eb8206b880efa59864d814b33b568065c835,0,0,0,0,0,
20200620,KS,12059,135590,,,1035,,338,,146,715,A,6/19/2020 09:00,Invalid DateTime,Invalid DateTime,254,1035,Invalid DateTime,,,,12059,20,0,0,147649,147649,0,147649,0,0,c1451bce890df5c3ce1725d3f03b654d089f0523,0,0,0,0,0,
20200619,KS,12059,135590,,,1035,,338,,146,715,A,6/19/2020 09:00,Invalid DateTime,Invalid DateTime,254,1035,Invalid DateTime,,,,12059,20,378,5147,147649,147649,5525,147649,7,24,1237503981647cedb776343b4f909a8d59ef916d,0,0,0,0,0,
20200618,KS,11681,130443,,,1011,,333,,146,696,A,6/17/2020 09:00,Invalid DateTime,Invalid DateTime,247,1011,Invalid DateTime,,,,11681,20,0,0,142124,142124,0,142124,0,0,7ee3785eac105f53bf266e4b571fdbb7c3102def,0,0,0,0,0,
20200617,KS,11681,130443,,,1011,,333,,146,696,A,6/17/2020 09:00,Invalid DateTime,Invalid DateTime,247,1011,Invalid DateTime,,,,11681,20,262,4900,142124,142124,5162,142124,2,23,af992bcd9aaa1d7e0ea49b6a01c326ab24a096f3,0,0,0,0,0,
20200616,KS,11419,125543,,,988,,327,,143,676,A,6/15/2020 12:30,Invalid DateTime,Invalid DateTime,245,988,Invalid DateTime,,,,11419,20,0,0,136962,136962,0,136962,0,0,4343db38b3d2e04c6bdaa4b0fbb620625f78b367,0,0,0,0,0,
20200615,KS,11419,125543,,,988,,327,,143,676,A,6/12/2020 12:30,Invalid DateTime,Invalid DateTime,245,988,Invalid DateTime,,,,11419,20,372,7438,136962,136962,7810,136962,2,15,9907c3b5653081bb5b4b9e49c87ec86a302ef5e5,0,0,0,0,0,
20200614,KS,11047,118105,,,973,,324,,143,667,A,6/12/2020 12:30,Invalid DateTime,Invalid DateTime,243,973,Invalid DateTime,,,,11047,20,0,0,129152,129152,0,129152,0,0,6b3b8e74b30f0a2036813957d895517038fca4d6,0,0,0,0,0,
20200613,KS,11047,118105,,,973,,324,,143,667,A,6/12/2020 12:30,Invalid DateTime,Invalid DateTime,243,973,Invalid DateTime,,,,11047,20,0,0,129152,129152,0,129152,0,0,d1a6745c8be9bb8d01f72cd50b7bfc0a1e604ad1,0,0,0,0,0,
20200612,KS,11047,118105,,,973,,324,,143,667,A,6/12/2020 12:30,Invalid DateTime,Invalid DateTime,243,973,Invalid DateTime,,,,11047,20,235,5175,129152,129152,5410,129152,3,19,6beac0c97b555e52bcce6678e004aca9702add3a,0,0,0,0,0,
20200611,KS,10812,112930,,,954,,316,,139,657,A,6/10/2020 09:00,Invalid DateTime,Invalid DateTime,240,954,Invalid DateTime,,,,10812,20,0,0,123742,123742,0,123742,0,0,79dad85d2a44b45472d8a0da3fc4fe7e548885f2,0,0,0,0,0,
20200610,KS,10812,112930,,,954,,316,,139,657,A,6/10/2020 09:00,Invalid DateTime,Invalid DateTime,240,954,Invalid DateTime,,,,10812,20,162,4071,123742,123742,4233,123742,4,18,72f2062625336e15622c131b41e5514217d4a36d,0,0,0,0,0,
20200609,KS,10650,108859,,,936,,311,,136,625,A,6/08/2020 09:00,Invalid DateTime,Invalid DateTime,236,936,Invalid DateTime,,,,10650,20,0,0,119509,119509,0,119509,0,0,58182678c00e1c19c935ef5b0bfd411d85c808af,0,0,0,0,0,
20200608,KS,10650,108859,,,936,,311,,136,625,A,6/08/2020 09:00,Invalid DateTime,Invalid DateTime,236,936,Invalid DateTime,,,,10650,20,257,5599,119509,119509,5856,119509,4,19,2db849e2f6abb1a06f9205686c5b8d77bba1530c,0,0,0,0,0,
20200607,KS,10393,103260,,,917,,306,,135,612,A,6/05/2020 09:00,Invalid DateTime,Invalid DateTime,232,917,Invalid DateTime,,,,10205,20,0,0,113653,113653,0,113653,0,0,decaf46a0580fdb98d14dce56bd02136d2152bad,0,0,0,0,0,
20200606,KS,10393,103260,,,917,,306,,135,612,A,6/05/2020 09:00,Invalid DateTime,Invalid DateTime,232,917,Invalid DateTime,,,,10205,20,0,0,113653,113653,0,113653,0,0,a587a408d78359d7eb18a174a0d94d5f7c6238d3,0,0,0,0,0,
20200605,KS,10393,103260,,,917,,306,,135,612,A,6/05/2020 09:00,Invalid DateTime,Invalid DateTime,232,917,Invalid DateTime,,,,10205,20,223,5377,113653,113653,5600,113653,10,27,5d0e0a3f2b72e4b3ebde68681d82729b11e10917,0,0,0,0,0,
20200604,KS,10170,97883,,,890,,302,,131,592,A,6/03/2020 09:00,Invalid DateTime,Invalid DateTime,222,890,Invalid DateTime,,,,9987,20,0,0,108053,108053,0,108053,0,0,e2ac7e9486d1d2c05285310c0e480d7d6699ae28,0,0,0,0,0,
20200603,KS,10170,97883,,,890,,302,,131,592,A,6/03/2020 09:00,Invalid DateTime,Invalid DateTime,222,890,Invalid DateTime,,,,9987,20,159,4582,108053,108053,4741,108053,5,28,16c30a48027af26f5469d5612baf8f7dac5e20e1,0,0,0,0,0,
20200602,KS,10011,93301,,,862,,290,,127,555,A,6/01/2020 09:00,Invalid DateTime,Invalid DateTime,217,862,Invalid DateTime,,,,9838,20,0,8071,103312,103312,8071,103312,0,20,deed4d8a7db81bec98638a2b0fd66a082211351d,0,0,0,0,0,
20200601,KS,10011,85230,,,842,,284,,124,547,A,6/01/2020 09:00,Invalid DateTime,Invalid DateTime,217,842,Invalid DateTime,,,,10011,20,292,0,95241,95241,292,95241,9,0,c8211aa144cc3d7066664961d476b4487db04b07,0,0,0,0,0,
20200531,KS,9719,85230,,,842,,284,,124,547,A,5/29/2020 09:00,Invalid DateTime,Invalid DateTime,208,842,Invalid DateTime,,,,9719,20,0,0,94949,94949,0,94949,0,0,b920849511d315b82b792981b00f2a570eb0d88d,0,0,0,0,0,
20200530,KS,9719,85230,,,842,,284,,124,547,A,5/29/2020 09:00,Invalid DateTime,Invalid DateTime,208,842,Invalid DateTime,,,,9719,20,0,0,94949,94949,0,94949,0,0,1dfcbf8da59c2584b7a291bec3902f9e57e1e4bb,0,0,0,0,0,
20200529,KS,9719,85230,,,842,,284,,124,547,A,5/29/2020 09:00,Invalid DateTime,Invalid DateTime,208,842,Invalid DateTime,,,,9719,20,382,10079,94949,94949,10461,94949,3,20,d4b79c4c6795efb3d1d93e18e6ebe8fe56fa3b9f,0,0,0,0,0,
20200528,KS,9337,75151,,,822,,275,,122,534,A,5/27/2020 09:00,Invalid DateTime,Invalid DateTime,205,822,Invalid DateTime,,,,9337,20,0,0,84488,84488,0,84488,0,0,07729a1fb98c7ed6fcb0fc153e0204acbf2e35b5,0,0,0,0,0,
20200527,KS,9337,75151,,,822,,275,,122,534,A,5/27/2020 09:00,Invalid DateTime,Invalid DateTime,205,822,Invalid DateTime,,,,9337,20,119,2970,84488,84488,3089,84488,17,22,a2751442d03e7bf8a75c29b47dc5dda9848bb190,0,0,0,0,0,
20200526,KS,9218,72181,,,800,,271,,120,493,A+,5/25/2020 09:00,Invalid DateTime,Invalid DateTime,188,800,Invalid DateTime,,,,9218,20,0,0,81399,81399,0,81399,0,0,784965add7d9c6385d6f627d1c5c47c26c27cb4b,0,0,0,0,0,
20200525,KS,9218,72181,,,800,,271,,120,493,A+,5/25/2020 09:00,Invalid DateTime,Invalid DateTime,188,800,Invalid DateTime,,,,9218,20,260,4705,81399,81399,4965,81399,3,13,b0bde2e8998ded91eb128f3b22226309a9fb802f,0,0,0,0,0,
20200524,KS,8958,67476,,,787,,269,,120,485,A+,5/22/2020 09:00,Invalid DateTime,Invalid DateTime,185,787,Invalid DateTime,,,,8958,20,0,0,76434,76434,0,76434,0,0,44c0b7506ceaa51ca974e020fc53071ef03969ea,0,0,0,0,0,
20200523,KS,8958,67476,,,787,,269,,120,485,A+,5/22/2020 09:00,Invalid DateTime,Invalid DateTime,185,787,Invalid DateTime,,,,8958,20,0,0,76434,76434,0,76434,0,0,e34124f3ad7bd82a6c635969edda728804e96fde,0,0,0,0,0,
20200522,KS,8958,67476,,,787,,269,,120,485,A+,5/22/2020 09:00,Invalid DateTime,Invalid DateTime,185,787,Invalid DateTime,,,,8958,20,419,4812,76434,76434,5231,76434,7,27,edfdd604cf7e83b81beb549f98e528ad5535c2bf,0,0,0,0,0,
20200521,KS,8539,62664,,,760,,258,,116,473,A+,5/20/2020 09:00,Invalid DateTime,Invalid DateTime,178,760,Invalid DateTime,,,,8539,20,0,0,71203,71203,0,71203,0,0,1893b791b37d77b8cd4d785b061a9acfb0335253,0,0,0,0,0,
20200520,KS,8539,62664,,,760,,258,,116,473,A+,5/20/2020 09:00,Invalid DateTime,Invalid DateTime,178,760,Invalid DateTime,,,,8539,20,199,4014,71203,71203,4213,71203,5,20,794a854fdc1b37f0ecb541f6aed92530e9f5fc73,0,0,0,0,0,
20200519,KS,8340,58650,,,740,,250,,115,465,A,5/18/2020 09:00,Invalid DateTime,Invalid DateTime,173,740,Invalid DateTime,,,,8340,20,0,0,66990,66990,0,66990,0,0,294917c2971670ec6321c4d4f9f0b4c4d954a2d4,0,0,0,0,0,
20200518,KS,8340,58650,,,740,,250,,115,465,A,5/18/2020 09:00,Invalid DateTime,Invalid DateTime,173,740,Invalid DateTime,,,,8232,20,454,4944,66990,66990,5398,66990,1,16,bfd092613fe65bfc7a621b69f841c510a7736203,0,0,0,0,0,
20200517,KS,7886,53706,,,724,,246,,112,443,A,5/15/2020 09:00,Invalid DateTime,Invalid DateTime,172,724,Invalid DateTime,,,,,20,0,0,61592,61592,0,61592,0,0,3aed8f8002800aa54acf1982350c42efc03b6f91,0,0,0,0,0,
20200516,KS,7886,53706,,,724,,246,,112,443,A,5/15/2020 09:00,Invalid DateTime,Invalid DateTime,172,724,Invalid DateTime,,,,,20,0,0,61592,61592,0,61592,0,0,cb8732bda21ff7becd9476b2d828371e79f702a9,0,0,0,0,0,
20200515,KS,7886,53706,,,724,,246,,112,443,A,5/15/2020 09:00,Invalid DateTime,Invalid DateTime,172,724,Invalid DateTime,,,,,20,418,3546,61592,61592,3964,61592,8,20,87e61e9174ad7569dcb6a23ed9129266791d6ded,0,0,0,0,0,
20200514,KS,7468,50160,,,704,,238,,108,422,A,5/13/2020 09:00,Invalid DateTime,Invalid DateTime,164,704,Invalid DateTime,,,,,20,0,0,57628,57628,0,57628,0,0,cc85b2f52393d663968b2680992db6dfce0227c8,0,0,0,0,0,
20200513,KS,7468,50160,,,704,,238,,108,422,A,5/13/2020 09:00,Invalid DateTime,Invalid DateTime,164,704,Invalid DateTime,,,,,20,352,3167,57628,57628,3519,57628,6,44,f6b0d1a13b63c764f3237065d4540b1e09fa63c1,0,0,0,0,0,
20200512,KS,7116,46993,,,660,,233,,101,376,A,5/11/2020 09:00,Invalid DateTime,Invalid DateTime,158,660,Invalid DateTime,,,,,20,0,0,54109,54109,0,54109,0,0,4acc3846a1bc7969adcbdd201d4ea687204e943c,0,0,0,0,0,
20200511,KS,7116,46993,,,660,,233,,101,376,A,5/11/2020 09:00,Invalid DateTime,Invalid DateTime,158,660,Invalid DateTime,,,,,20,168,1436,54109,54109,1604,54109,1,3,25de4ae4306199584e3b064965fcbae369e4730b,0,0,0,0,0,
20200510,KS,6948,45557,,,657,,231,,101,371,A,5/10/2020 09:00,Invalid DateTime,Invalid DateTime,157,657,Invalid DateTime,,,,,20,197,2375,52505,52505,2572,52505,0,22,9befcf9f9b326601e511958cc3ccc74f4e792e73,0,0,0,0,0,
20200509,KS,6751,43182,,,635,,229,,100,350,A,5/09/2020 09:00,Invalid DateTime,Invalid DateTime,157,635,Invalid DateTime,,,,6144,20,250,1975,49933,49933,2225,49933,5,27,f5460e0fd5b46c80272ed4d4cbf31926edcbf3c1,0,0,0,0,0,
20200508,KS,6501,41207,,,608,,223,,99,332,A,5/08/2020 09:00,Invalid DateTime,Invalid DateTime,152,608,Invalid DateTime,,,,6144,20,357,2529,47708,47708,2886,47708,5,21,9e7d4e7c706805b2bbe770343fe1148324a17f47,0,0,0,0,0,
20200507,KS,6144,38678,,,587,,218,,97,323,A,5/07/2020 09:00,Invalid DateTime,Invalid DateTime,147,587,Invalid DateTime,,,,6144,20,410,2298,44822,44822,2708,44822,3,16,cac96ca17a97c8bc8c14f9891e02eee5bd69fb4a,0,0,0,0,0,
20200506,KS,5734,36380,,,571,,213,,96,318,A,5/06/2020 09:00,Invalid DateTime,Invalid DateTime,144,571,Invalid DateTime,,,,5734,20,276,1746,42114,42114,2022,42114,7,5,01b6add99c1dee0c2d2ab5891b98c3d9b716d935,0,0,0,0,0,
20200505,KS,5458,34634,,,566,,212,,95,296,A,5/05/2020 09:00,Invalid DateTime,Invalid DateTime,137,566,Invalid DateTime,,,,5458,20,213,1276,40092,40092,1489,40092,1,13,5c9e445a268b332272479cb46531acd4e1a2fa2b,0,0,0,0,0,
20200504,KS,5245,33358,,,553,,209,,95,291,A,5/03/2020 09:00,Invalid DateTime,Invalid DateTime,136,553,Invalid DateTime,,,,5245,20,215,1610,38603,38603,1825,38603,2,6,37cd031a928eaf99b4b64d547136570bd08b87c9,0,0,0,0,0,
20200503,KS,5030,31748,,,547,,209,,95,286,A,5/03/2020 09:00,Invalid DateTime,Invalid DateTime,134,547,Invalid DateTime,,,,5030,20,284,1552,36778,36778,1836,36778,3,6,b0b8b6f6cd85baf3d2d8a4936f4be2fa3ef25f61,0,0,0,0,0,
20200502,KS,4746,30196,,,541,,206,,95,286,A,5/02/2020 09:00,Invalid DateTime,Invalid DateTime,131,541,Invalid DateTime,,,,4746,20,297,1611,34942,34942,1908,34942,1,7,0b22eca8004189b91328bc533b379dd949b27f04,0,0,0,0,0,
20200501,KS,4449,28585,,,534,,206,,96,280,A,5/01/2020 09:00,Invalid DateTime,Invalid DateTime,130,534,Invalid DateTime,,,,4449,20,211,1197,33034,33034,1408,33034,1,11,c273ac6841df7f622108c505b173ddbfdc8c13eb,0,0,0,0,0,
20200430,KS,4238,27388,,,523,,201,,93,272,A,4/30/2020 09:00,Invalid DateTime,Invalid DateTime,129,523,Invalid DateTime,,,,4238,20,500,1668,31626,31626,2168,31626,4,8,1714bb1f3d3c7cf9ad943639c2f21258ed9128c5,0,0,0,0,0,
20200429,KS,3738,25720,,,515,,198,,88,266,A,4/29/2020 09:00,Invalid DateTime,Invalid DateTime,125,515,Invalid DateTime,,,,3738,20,247,1121,29458,29458,1368,29458,1,11,244092d40713ea14dc72c88bd8313169d316e177,0,0,0,0,0,
20200428,KS,3491,24599,,,504,,,,,,C,4/28/2020 09:00,Invalid DateTime,Invalid DateTime,124,504,Invalid DateTime,,,,,20,163,760,28090,28090,923,28090,4,8,5865f2d5b1d52651492d7d1973ed6aecfec6f3d2,0,0,0,0,0,
20200427,KS,3328,23839,,,496,,,,,,C,4/26/2020 10:00,Invalid DateTime,Invalid DateTime,120,496,Invalid DateTime,,,,,20,154,786,27167,27167,940,27167,2,11,bf94bf1ae76cb3cabcbed843b6aea4b96e7859f5,0,0,0,0,0,
20200426,KS,3174,23053,,,485,,,,,,C,4/26/2020 10:00,Invalid DateTime,Invalid DateTime,118,485,Invalid DateTime,,,,,20,118,910,26227,26227,1028,26227,1,11,352d78f5329b3bc088886d5807c643cd1c10f835,0,0,0,0,0,
20200425,KS,3056,22143,,,474,,,,,,C,4/25/2020 10:00,Invalid DateTime,Invalid DateTime,117,474,Invalid DateTime,,,,,20,279,1332,25199,25199,1611,25199,6,17,98408c4a78734fb122fe0e022fcd0c7a6dfc30a9,0,0,0,0,0,
20200424,KS,2777,20811,,,457,,,,,,B,4/24/2020 09:00,Invalid DateTime,Invalid DateTime,111,457,Invalid DateTime,,,,,20,295,1975,23588,23588,2270,23588,-1,15,7244ccd90fb588f1c6687fcc842da17c50e0dd32,0,0,0,0,0,
20200423,KS,2482,18836,,,442,,,,,,B,4/23/2020 09:45,Invalid DateTime,Invalid DateTime,112,442,Invalid DateTime,,,,,20,271,844,21318,21318,1115,21318,2,10,53b6691df834279a135c504bf40dc5ef354d4c39,0,0,0,0,0,
20200422,KS,2211,17992,,,432,,,,,,B,4/22/2020 11:00,Invalid DateTime,Invalid DateTime,110,432,Invalid DateTime,,,,,20,186,916,20203,20203,1102,20203,3,13,a2756d429d820936031317a0be370c48825755f6,0,0,0,0,0,
20200421,KS,2025,17076,,,419,,,,,,B,4/21/2020 11:00,Invalid DateTime,Invalid DateTime,107,419,Invalid DateTime,,,,,20,39,301,19101,19101,340,19101,7,14,3c273748b923350da2605fd29aeb1dcd387cbbe7,0,0,0,0,0,
20200420,KS,1986,16775,,,405,,,,,,B,4/20/2020 11:00,Invalid DateTime,Invalid DateTime,100,405,Invalid DateTime,,,,,20,137,494,18761,18761,631,18761,8,15,8d6fb22a7636fd0ee476c38bff21eeb96743c341,0,0,0,0,0,
20200419,KS,1849,16281,,,390,,,,,,B,4/19/2020 11:00,Invalid DateTime,Invalid DateTime,92,390,Invalid DateTime,,,,,20,59,395,18130,18130,454,18130,6,7,562749e4399f7528947dde97e24350704e2d3540,0,0,0,0,0,
20200418,KS,1790,15886,,,383,,,,,,B,4/18/2020 11:00,Invalid DateTime,Invalid DateTime,86,383,Invalid DateTime,,,,,20,85,690,17676,17676,775,17676,2,8,0d278f269676bca163d180d91c0910ee34650666,0,0,0,0,0,
20200417,KS,1705,15196,,,375,,,,,,B,4/17/2020 11:00,Invalid DateTime,Invalid DateTime,84,375,Invalid DateTime,,,,,20,117,662,16901,16901,779,16901,4,16,243e7f8c7e78b93b263038be81dca3ef73db57e7,0,0,0,0,0,
20200416,KS,1588,14534,,,359,,,,,,B,4/16/2020 11:00,Invalid DateTime,Invalid DateTime,80,359,Invalid DateTime,,,,,20,94,1360,16122,16122,1454,16122,4,17,b4e44f825f358e4ed446dfb39a064522edcc53c7,0,0,0,0,0,
20200415,KS,1494,13174,,,342,,,,,,B,4/15/2020 10:30,Invalid DateTime,Invalid DateTime,76,342,Invalid DateTime,,,,,20,68,453,14668,14668,521,14668,7,15,a6aed8fc3fab74951a9124ce229789cf0114d404,0,0,0,0,0,
20200414,KS,1426,12721,,,327,,,,,,B,4/14/2020 11:00,Invalid DateTime,Invalid DateTime,69,327,Invalid DateTime,,,,,20,50,233,14147,14147,283,14147,7,18,59b28ef895730fea55175adcea465b0cb28344da,0,0,0,0,0,
20200413,KS,1376,12488,,,309,,,,,,B,4/13/2020 10:30,Invalid DateTime,Invalid DateTime,62,309,Invalid DateTime,,,,,20,39,572,13864,13864,611,13864,6,11,8b2f4d02aaac9970104a24e2b3ff843e4687b239,0,0,0,0,0,
20200412,KS,1337,11916,,,298,,,,,,B,4/12/2020 11:00,Invalid DateTime,Invalid DateTime,56,298,Invalid DateTime,,,,,20,69,841,13253,13253,910,13253,1,5,81ab1f484a8853a55c10844e112560d16c6a6c9f,0,0,0,0,0,
20200411,KS,1268,11075,,,293,,,,,,B,4/11/2020 10:00,Invalid DateTime,Invalid DateTime,55,293,Invalid DateTime,,,,,20,102,827,12343,12343,929,12343,5,19,87f01bafe14fc75f28e7ae70e884e15eef146d5b,0,0,0,0,0,
20200410,KS,1166,10248,,,274,,,,,,B,4/10/2020 08:30,Invalid DateTime,Invalid DateTime,50,274,Invalid DateTime,,,,,20,60,579,11414,11414,639,11414,8,11,1cf0c6da6ee612f190dc97480f5947c6aec7da5b,0,0,0,0,0,
20200409,KS,1106,9669,,,263,,,,,,B,4/09/2020 11:00,Invalid DateTime,Invalid DateTime,42,263,Invalid DateTime,,,,,20,60,532,10775,10775,592,10775,4,40,eb157b1155e3a705c3bdde5d60d8474f3680b7b1,0,0,0,0,0,
20200408,KS,1046,9137,,,223,,,,,,B,4/07/2020 11:00,Invalid DateTime,Invalid DateTime,38,223,Invalid DateTime,,,,,20,146,523,10183,10183,669,10183,11,0,2136582a0e0c16e530a33c173eb30589b133214e,0,0,0,0,0,
20200407,KS,900,8614,,,223,,,,,,B,4/07/2020 11:00,Invalid DateTime,Invalid DateTime,27,223,Invalid DateTime,,,,,20,55,375,9514,9514,430,9514,2,25,adc4e9e94912d8d9f69d960092224c977167e6cf,0,0,0,0,0,
20200406,KS,845,8239,,,198,,,,,,B,4/06/2020 11:00,Invalid DateTime,Invalid DateTime,25,198,Invalid DateTime,,,,,20,98,763,9084,9084,861,9084,3,15,4dc9157c5b8181c14cfd4a94eb58185abe2cd7d9,0,0,0,0,0,
20200405,KS,747,7476,,,183,,,,,,B,4/05/2020 11:00,Invalid DateTime,Invalid DateTime,22,183,Invalid DateTime,,,,,20,49,596,8223,8223,645,8223,1,11,14347d2f8191850353b01c43831151bbbb90c7e1,0,0,0,0,0,
20200404,KS,698,6880,,,172,,,,,,B,4/04/2020 11:00,Invalid DateTime,Invalid DateTime,21,172,Invalid DateTime,,,,,20,78,426,7578,7578,504,7578,4,21,934e58ea1131f759ec0e2888214c57d816c138a0,0,0,0,0,0,
20200403,KS,620,6454,,,151,,,,,,B,4/03/2020 11:00,Invalid DateTime,Invalid DateTime,17,151,Invalid DateTime,,,,,20,68,395,7074,7074,463,7074,4,13,a00d5c513ee31f89ad1bad0b3a767695d68643bf,0,0,0,0,0,
20200402,KS,552,6059,,,138,,,,,,B,4/02/2020 11:00,Invalid DateTime,Invalid DateTime,13,138,Invalid DateTime,,,,,20,70,648,6611,6611,718,6611,3,24,00773f4e9052df7db01b19200f675a1152d255bd,0,0,0,0,0,
20200401,KS,482,5411,,,114,,,,,,B,4/01/2020 10:00,Invalid DateTime,Invalid DateTime,10,114,Invalid DateTime,,,,,20,54,415,5893,5893,469,5893,1,35,5d9c86299393bc632c97fbdde0c8d09cb9f539d8,0,0,0,0,0,
20200331,KS,428,4996,,,79,,,,,,B,3/31/2020 10:00,Invalid DateTime,Invalid DateTime,9,79,Invalid DateTime,,,,,20,60,442,5424,5424,502,5424,1,13,1a5c8700089f147ab3bece08b664b5adf351f218,0,0,0,0,0,
20200330,KS,368,4554,,,66,,,,,,B,3/30/2020 10:00,Invalid DateTime,Invalid DateTime,8,66,Invalid DateTime,,,,,20,49,360,4922,4922,409,4922,2,11,06eacfa29b6bd82cb6b8e8417291718b063cf5ee,0,0,0,0,0,
20200329,KS,319,4194,,,55,,,,,,B,3/29/2020 10:00,Invalid DateTime,Invalid DateTime,6,55,Invalid DateTime,,,,,20,58,523,4513,4513,581,4513,1,28,fb3b9d69b82f5b5e95dececf35673199739f2504,0,0,0,0,0,
20200328,KS,261,3671,,,27,,,,,,B,3/27/2020 08:00,Invalid DateTime,Invalid DateTime,5,27,Invalid DateTime,,,,,20,59,442,3932,3932,501,3932,1,0,3bfd9ca7a41d91fb48319ea09617de5efc26e5d8,0,0,0,0,0,
20200327,KS,202,3229,,,27,,,,,,B,3/27/2020 08:00,Invalid DateTime,Invalid DateTime,4,27,Invalid DateTime,,,,,20,34,360,3431,3431,394,3431,1,27,8b1a53d8b32aa6c6013c6e5cb9188aac38a9fd0c,0,0,0,0,0,
20200326,KS,168,2869,,,,,,,,,B,3/26/2020 11:00,Invalid DateTime,Invalid DateTime,3,,Invalid DateTime,,,,,20,42,509,3037,3037,551,3037,0,0,687e9bd0edab2d53f50e35e80389ee40301e4d41,0,0,0,0,0,
20200325,KS,126,2360,,,,,,,,,B,3/25/2020 11:00,Invalid DateTime,Invalid DateTime,3,,Invalid DateTime,,,,,20,28,274,2486,2486,302,2486,1,0,b62a24fe77514f04d37ba8d7c157cca3ee9da1de,0,0,0,0,0,
20200324,KS,98,2086,,,,,,,,,B,3/24/2020 11:00,Invalid DateTime,Invalid DateTime,2,,Invalid DateTime,,,,,20,16,1669,2184,2184,1685,2184,0,0,f330b3d40970a7666286c7a73f461d0ae2363760,0,0,0,0,0,
20200323,KS,82,417,,,,,,,,,B,3/23/2020 10:00,Invalid DateTime,Invalid DateTime,2,,Invalid DateTime,,,,,20,18,0,499,499,18,499,0,0,c40e32b4bdbbe6b4b1ec39d3bd21d1763f13082c,0,0,0,0,0,
20200322,KS,64,417,,,,,,,,,,3/21/2020 10:00,Invalid DateTime,Invalid DateTime,2,,Invalid DateTime,,,,,20,9,0,481,481,9,481,0,0,752d221197a65c997bcff58ae411ebd253e5c173,0,0,0,0,0,
20200321,KS,55,417,,,,,,,,,,3/21/2020 10:00,Invalid DateTime,Invalid DateTime,2,,Invalid DateTime,,,,,20,11,0,472,472,11,472,1,0,1a6412c805a7b87515906377ad4db8563dc037d3,0,0,0,0,0,
20200320,KS,44,417,,,,,,,,,,3/20/2020 10:00,Invalid DateTime,Invalid DateTime,1,,Invalid DateTime,,,,,20,10,0,461,461,10,461,0,0,298e1a03404e0dacc1cba3a9107292e7def4d27a,0,0,0,0,0,
20200319,KS,34,417,,,,,,,,,,3/19/2020 10:00,Invalid DateTime,Invalid DateTime,1,,Invalid DateTime,,,,,20,18,0,451,451,18,451,0,0,ddaec6ceea6e4a03be48a716f49fe53a6e117b42,0,0,0,0,0,
20200318,KS,16,417,,,,,,,,,,3/17/2020 14:30,Invalid DateTime,Invalid DateTime,1,,Invalid DateTime,,,,,20,1,35,433,433,36,433,0,0,884b793e1ff148616ef18ba58f58e9a915969865,0,0,0,0,0,
20200317,KS,15,382,,,,,,,,,,3/17/2020 12:00,Invalid DateTime,Invalid DateTime,1,,Invalid DateTime,,,,,20,4,216,397,397,220,397,0,0,4c92041404794fbdf6cbe3055853c4bcf48b077c,0,0,0,0,0,
20200316,KS,11,166,,,,,,,,,,3/16/2020 15:17,Invalid DateTime,Invalid DateTime,1,,Invalid DateTime,,,,,20,3,31,177,177,34,177,0,0,ace285d621ba499f4d79b0c7f66ee77607481908,0,0,0,0,0,
20200315,KS,8,135,,,,,,,,,,3/14/2020 12:00,Invalid DateTime,Invalid DateTime,1,,Invalid DateTime,,,,,20,2,42,143,143,44,143,0,0,82785a559c8e51b6bf83a6fbe3fbfbe8247ce7fa,0,0,0,0,0,
20200314,KS,6,93,,,,,,,,,,3/13/2020 10:00,Invalid DateTime,Invalid DateTime,1,,Invalid DateTime,,,,,20,0,0,99,99,0,99,1,0,46ea0219f80c838f23cd8b7552f7566b826e4e5a,0,0,0,0,0,
20200313,KS,6,93,,,,,,,,,,3/13/2020 10:00,Invalid DateTime,Invalid DateTime,,,Invalid DateTime,,,,,20,-991,78,99,99,-913,99,0,0,f04a314cd7b6a09212810f5fdac73a056d9a45f6,0,0,0,0,0,
20200312,KS,997,15,,,,,,,,,,3/11/2020 23:00,Invalid DateTime,Invalid DateTime,,,Invalid DateTime,28,13,15,1353,20,996,-26,1012,1012,970,1012,0,0,2e9f20d77b932f965928454e1fc53c9853464ad4,0,0,0,0,0,
20200311,KS,1,41,,,,,,,,,,,,,,,,,,,,20,0,24,42,42,24,42,0,0,8ecca436de3d1cf98b012681ad39deca8f08a9ca,0,0,0,0,0,
20200310,KS,1,17,21,,,,,,,,,,,,,,,,,,,20,0,6,39,18,6,18,0,0,507683c83efa2b95732149970604dbd9c463ee85,0,0,0,0,0,
20200309,KS,1,11,0,,,,,,,,,,,,,,,,,,,20,0,0,12,12,0,12,0,0,861ca46bf59eb44961252823762a2ab76f2e8e3f,0,0,0,0,0,
20200308,KS,1,11,0,,,,,,,,,,,,,,,,,,,20,1,0,12,12,1,12,0,0,bfddd4da7e867b72c0676fd90f166d058947e1e2,0,0,0,0,0,
20200307,KS,0,11,2,,,,,,,,,,,,,,,,,,,20,0,7,13,11,7,11,0,0,2580ef422f2ad47972e702c73f79b3fc7ac91341,0,0,0,0,0,
20200306,KS,0,4,0,,,,,,,,,,,,,,,,,,,20,0,0,4,4,0,4,0,0,87318388ea71de0e5def0594e7ad2756ad7cd736,0,0,0,0,0,
