date,state,positive,negative,pending,hospitalizedCurrently,hospitalizedCumulative,inIcuCurrently,inIcuCumulative,onVentilatorCurrently,onVentilatorCumulative,recovered,dataQualityGrade,lastUpdateEt,dateModified,checkTimeEt,death,hospitalized,dateChecked,fips,positiveIncrease,negativeIncrease,total,totalTestResults,totalTestResultsIncrease,posNeg,deathIncrease,hospitalizedIncrease,hash,commercialScore,negativeRegularScore,negativeScore,positiveScore,score,grade
20200610,TN,28061,500766,,,1990,,,,,18516,B,"Wed, 10 Jun 2020 18:00:00 GMT",2020-06-10T18:00:00Z,06/10 14:00,436,1990,2020-06-10T18:00:00Z,47,486,7144,528827,528827,7630,528827,1,16,9dbd32bb28e77d9ecf6f65d0576accbb68888896,0,0,0,0,0,
20200609,TN,27575,493622,,,1974,,,,,18013,B,"Tue, 09 Jun 2020 18:00:00 GMT",2020-06-09T18:00:00Z,06/09 14:00,435,1974,2020-06-09T18:00:00Z,47,631,7803,521197,521197,8434,521197,14,26,1b85986e063993fbbbce4ce1d2c9ee474564fdb6,0,0,0,0,0,
20200608,TN,26944,485819,,,1948,,,,,17563,B,"Mon, 08 Jun 2020 18:00:00 GMT",2020-06-08T18:00:00Z,06/08 14:00,421,1948,2020-06-08T18:00:00Z,47,563,13432,512763,512763,13995,512763,3,16,5d8c58c44cf53a81908441f9efa8372a54b4bc15,0,0,0,0,0,
20200607,TN,26381,472387,,,1932,,,,,17222,B,"Sun, 07 Jun 2020 18:00:00 GMT",2020-06-07T18:00:00Z,06/07 14:00,418,1932,2020-06-07T18:00:00Z,47,310,7037,498768,498768,7347,498768,1,9,de60c874783d17ad86aa6a68ea41df868086cc04,0,0,0,0,0,
20200606,TN,26071,465350,,,1923,,,,,17124,B,"Sat, 06 Jun 2020 18:00:00 GMT",2020-06-06T18:00:00Z,06/06 14:00,417,1923,2020-06-06T18:00:00Z,47,551,8698,491421,491421,9249,491421,9,30,fa6129ed46eadea1b26d0cf2148ec43b12357826,0,0,0,0,0,
20200605,TN,25520,456652,,,1893,,,,,16925,B,"Fri, 05 Jun 2020 18:00:00 GMT",2020-06-05T18:00:00Z,06/05 14:00,408,1893,2020-06-05T18:00:00Z,47,400,5634,482172,482172,6034,482172,7,38,04ad5ca7658cf94214819677c232e0466889b197,0,0,0,0,0,
20200604,TN,25120,451018,,,1855,,,,,16643,B,"Thu, 04 Jun 2020 18:00:00 GMT",2020-06-04T18:00:00Z,06/04 14:00,401,1855,2020-06-04T18:00:00Z,47,298,5061,476138,476138,5359,476138,13,26,1d441862861b5de9ae30b3d963459c55c89dab28,0,0,0,0,0,
20200603,TN,24822,445957,,,1829,,,,,16319,B,"Wed, 03 Jun 2020 18:00:00 GMT",2020-06-03T18:00:00Z,06/03 14:00,388,1829,2020-06-03T18:00:00Z,47,447,8196,470779,470779,8643,470779,7,37,e36667cb174d2598de91198b4b150e962b9f87da,0,0,0,0,0,
20200602,TN,24375,437761,,,1792,,,,,15916,B,"Tue, 02 Jun 2020 18:00:00 GMT",2020-06-02T18:00:00Z,06/02 14:00,381,1792,2020-06-02T18:00:00Z,47,821,12822,462136,462136,13643,462136,14,25,ec795e641cdb558e07479fc1cd998aeb7fac6471,0,0,0,0,0,
20200601,TN,23554,424939,,,1767,,,,,15564,B,"Mon, 01 Jun 2020 18:00:00 GMT",2020-06-01T18:00:00Z,06/01 14:00,367,1767,2020-06-01T18:00:00Z,47,548,11968,448493,448493,12516,448493,3,17,74f806fb9c8b65756435cff3621afc7031ecae25,0,0,0,0,0,
20200531,TN,23006,412971,,,1750,,,,,15300,B,"Sat, 30 May 2020 18:00:00 GMT",2020-05-30T18:00:00Z,05/30 14:00,364,1750,2020-05-30T18:00:00Z,47,440,8491,435977,435977,8931,435977,0,18,904fa3fe1b93abfa2de3033e9465864aca3f3024,0,0,0,0,0,
20200530,TN,22566,404480,,,1732,,,,,15193,B,"Sat, 30 May 2020 18:00:00 GMT",2020-05-30T18:00:00Z,05/30 14:00,364,1732,2020-05-30T18:00:00Z,47,481,4598,427046,427046,5079,427046,4,22,13fdb5dee0b6ad9f539ebfad2df27bcebfe9f55d,0,0,0,0,0,
20200529,TN,22085,399882,,,1710,,,,,14965,B,"Fri, 29 May 2020 18:00:00 GMT",2020-05-29T18:00:00Z,05/29 14:00,360,1710,2020-05-29T18:00:00Z,47,406,5572,421967,421967,5978,421967,4,21,ae88dd87b5dae1c7ee2cf902df9418b02518be8c,0,0,0,0,0,
20200528,TN,21679,394310,,,1689,,,,,14632,B,"Thu, 28 May 2020 18:00:00 GMT",2020-05-28T18:00:00Z,05/28 14:00,356,1689,2020-05-28T18:00:00Z,47,373,5986,415989,415989,6359,415989,3,42,52ba7dd2f21601433972b4d64c0a7ff6b4984ec1,0,0,0,0,0,
20200527,TN,21306,388324,,,1647,,,,,13916,B,"Wed, 27 May 2020 18:00:00 GMT",2020-05-27T18:00:00Z,05/27 14:00,353,1647,2020-05-27T18:00:00Z,47,341,5785,409630,409630,6126,409630,10,38,4e7eb7a99e4bd76b6abbc3c4f29249bccb439205,0,0,0,0,0,
20200526,TN,20965,382539,,,1609,,,,,13344,B,"Tue, 26 May 2020 18:00:00 GMT",2020-05-26T18:00:00Z,05/26 14:00,343,1609,2020-05-26T18:00:00Z,47,358,6927,403504,403504,7285,403504,5,15,febc88e08709ef7910b292090c4cafc4c02e314a,0,0,0,0,0,
20200525,TN,20607,375612,,,1594,,,,,13073,B,"Mon, 25 May 2020 18:00:00 GMT",2020-05-25T18:00:00Z,05/25 14:00,338,1594,2020-05-25T18:00:00Z,47,462,12181,396219,396219,12643,396219,2,11,20bb128ee43ade048834d5856a078fa9197b2e65,0,0,0,0,0,
20200524,TN,20145,363431,,,1583,,,,,12837,B,"Sun, 24 May 2020 18:00:00 GMT",2020-05-24T18:00:00Z,05/24 14:00,336,1583,2020-05-24T18:00:00Z,47,356,9462,383576,383576,9818,383576,7,10,5becf91f561fc4565dfb62043a613791e4677361,0,0,0,0,0,
20200523,TN,19789,353969,,,1573,,,,,12745,B,"Sat, 23 May 2020 18:00:00 GMT",2020-05-23T18:00:00Z,05/23 14:00,329,1573,2020-05-23T18:00:00Z,47,395,12347,373758,373758,12742,373758,14,13,2c46730774e30a524c626968385f5e71222e806d,0,0,0,0,0,
20200522,TN,19394,341622,,,1560,,,,,12566,B,"Fri, 22 May 2020 18:00:00 GMT",2020-05-22T18:00:00Z,05/22 14:00,315,1560,2020-05-22T18:00:00Z,47,433,0,361016,361016,433,361016,2,21,9e7772f0bfdc944bf4ba3a5b3dc6bdfa88ebb402,0,0,0,0,0,
20200521,TN,18961,341622,,,1539,,,,,12191,B,"Thu, 21 May 2020 18:00:00 GMT",2020-05-21T18:00:00Z,05/21 14:00,313,1539,2020-05-21T18:00:00Z,47,429,6141,360583,360583,6570,360583,4,24,ba37111d781ef5b4b8080265db88173f4c81c544,0,0,0,0,0,
20200520,TN,18532,335481,,,1515,,,,,11783,B,"Wed, 20 May 2020 18:00:00 GMT",2020-05-20T18:00:00Z,05/20 14:00,309,1515,2020-05-20T18:00:00Z,47,154,7736,354013,354013,7890,354013,4,17,155ace3364f40c14520405e6e585ea5f23a95b11,0,0,0,0,0,
20200519,TN,18378,327745,,,1498,,,,,10969,A,"Tue, 19 May 2020 18:00:00 GMT",2020-05-19T18:00:00Z,05/19 14:00,305,1498,2020-05-19T18:00:00Z,47,367,8328,346123,346123,8695,346123,4,9,7189568b9e197324852846c34a3b0d968ce0ba55,0,0,0,0,0,
20200518,TN,18011,319417,,,1489,,,,,9886,A,"Mon, 18 May 2020 18:00:00 GMT",2020-05-18T18:00:00Z,05/18 14:00,301,1489,2020-05-18T18:00:00Z,47,623,11525,337428,337428,12148,337428,3,7,f47d242f9e19f5a5b82bc96107126e5f05ead1b2,0,0,0,0,0,
20200517,TN,17388,307892,,,1482,,,,,9652,A,"Sun, 17 May 2020 18:00:00 GMT",2020-05-17T18:00:00Z,05/17 14:00,298,1482,2020-05-17T18:00:00Z,47,100,4979,325280,325280,5079,325280,3,8,878f6d26fc480ad27341eb034f14d81ed1712286,0,0,0,0,0,
20200516,TN,17288,302913,,,1474,,,,,9529,A,"Sat, 16 May 2020 18:00:00 GMT",2020-05-16T18:00:00Z,05/16 14:00,295,1474,2020-05-16T18:00:00Z,47,318,10127,320201,320201,10445,320201,5,20,fa9a395019aef97c98b26d6b803c5927e1404a8e,0,0,0,0,0,
20200515,TN,16970,292786,,,1454,,,,,9280,A,"Fri, 15 May 2020 18:00:00 GMT",2020-05-15T18:00:00Z,05/15 14:00,290,1454,2020-05-15T18:00:00Z,47,271,7168,309756,309756,7439,309756,3,19,ea4102e26fb94a257871b320164ee8544107404d,0,0,0,0,0,
20200514,TN,16699,285618,,,1435,,,,,8881,A,"Thu, 14 May 2020 18:00:00 GMT",2020-05-14T18:00:00Z,05/14 14:00,287,1435,2020-05-14T18:00:00Z,47,329,9071,302317,302317,9400,302317,14,47,d829e36b4e94b28908860a8cfd2bafec61cdf29a,0,0,0,0,0,
20200513,TN,16370,276547,,,1388,,,,,8624,A,"Wed, 13 May 2020 18:00:00 GMT",2020-05-13T18:00:00Z,05/13 14:00,273,1388,2020-05-13T18:00:00Z,47,259,8834,292917,292917,9093,292917,8,25,5cb4cf5d0b8c8719bdf8c04365e393fafeb78e5e,0,0,0,0,0,
20200512,TN,16111,267713,,,1363,,,,,8336,A,"Tue, 12 May 2020 19:00:00 GMT",2020-05-12T19:00:00Z,05/12 15:00,265,1363,2020-05-12T19:00:00Z,47,567,9980,283824,283824,10547,283824,14,19,606ed66c2f6c571550e87a4f7f0cd4d8cde1d61c,0,0,0,0,0,
20200511,TN,15544,257733,,,1344,,,,,8038,B,"Mon, 11 May 2020 18:00:00 GMT",2020-05-11T18:00:00Z,05/11 14:00,251,1344,2020-05-11T18:00:00Z,47,559,10849,273277,273277,11408,273277,8,19,52cdc73f29aed8309afcf9cad8ec4c0a26eff8ac,0,0,0,0,0,
20200510,TN,14985,246884,,,1325,,,,,7528,B,"Sun, 10 May 2020 03:00:00 GMT",2020-05-10T03:00:00Z,05/09 23:00,243,1325,2020-05-10T03:00:00Z,47,217,8904,261869,261869,9121,261869,1,6,8e1f1e9c965204ded947000e587461065315493d,0,0,0,0,0,
20200509,TN,14768,237980,,,1319,,,,,7369,B,"Sat, 09 May 2020 03:00:00 GMT",2020-05-09T03:00:00Z,05/08 23:00,242,1319,2020-05-09T03:00:00Z,47,327,8843,252748,252748,9170,252748,1,20,a079057829b99eeca44d58ac4fd5912562d3c625,0,0,0,0,0,
20200508,TN,14441,229137,,,1299,,,,,7011,B,"Fri, 08 May 2020 03:00:00 GMT",2020-05-08T03:00:00Z,05/07 23:00,241,1299,2020-05-08T03:00:00Z,47,345,6905,243578,243578,7250,243578,4,33,6a6ea0435361a2e52228d4bedbf6599983bcaccb,0,0,0,0,0,
20200507,TN,14096,222232,,,1266,,,,,6783,B,"Thu, 07 May 2020 18:00:00 GMT",2020-05-07T18:00:00Z,05/07 14:00,237,1266,2020-05-07T18:00:00Z,47,158,9069,236328,236328,9227,236328,-2,45,cccadc4bf2a9b8a8be724b4dbc11c81e1aec4afb,0,0,0,0,0,
20200506,TN,13938,213163,,,1221,,,,,6564,B,"Wed, 06 May 2020 18:00:00 GMT",2020-05-06T18:00:00Z,05/06 14:00,239,1221,2020-05-06T18:00:00Z,47,248,7991,227101,227101,8239,227101,13,65,f5894293cbfc827a4f34d81cb3dbfde767765ca7,0,0,0,0,0,
20200505,TN,13690,205172,,,1156,,,,,6356,B,"Tue, 05 May 2020 18:00:00 GMT",2020-05-05T18:00:00Z,05/05 14:00,226,1156,2020-05-05T18:00:00Z,47,119,7300,218862,218862,7419,218862,7,13,22c3597d3525e7365bd6d7b39e3ede64ac96eb60,0,0,0,0,0,
20200504,TN,13571,197872,,,1143,,,,,6081,B,"Mon, 04 May 2020 18:00:00 GMT",2020-05-04T18:00:00Z,05/04 14:00,219,1143,2020-05-04T18:00:00Z,47,394,6442,211443,211443,6836,211443,9,8,0e472eb746f621384c5a516a8c5fd8b43d09908c,0,0,0,0,0,
20200503,TN,13177,191430,,,1135,,,,,5814,B,"Sun, 03 May 2020 18:00:00 GMT",2020-05-03T18:00:00Z,05/03 14:00,210,1135,2020-05-03T18:00:00Z,47,516,7815,204607,204607,8331,204607,1,10,d9aa5a51a851961a5cfa9047d746a80806ef04f4,0,0,0,0,0,
20200502,TN,12661,183615,,,1125,,,,,5718,B,"Sat, 02 May 2020 18:00:00 GMT",2020-05-02T18:00:00Z,05/02 14:00,209,1125,2020-05-02T18:00:00Z,47,770,9374,196276,196276,10144,196276,5,12,e871197e5c535d2a675810d9a0e24ddbbce1ceca,0,0,0,0,0,
20200501,TN,11891,174241,,,1113,,,,,5546,B,"Fri, 01 May 2020 18:00:00 GMT",2020-05-01T18:00:00Z,05/01 14:00,204,1113,2020-05-01T18:00:00Z,47,1156,7350,186132,186132,8506,186132,5,68,8bb805f5f8a84b6c485f4dc8483690f25fe2d354,0,0,0,0,0,
20200430,TN,10735,166891,,,1045,,,,,5338,B,"Tue, 28 Apr 2020 18:00:00 GMT",2020-04-28T18:00:00Z,04/28 14:00,199,1045,2020-04-28T18:00:00Z,47,369,8708,177626,177626,9077,177626,4,32,8d094b8ea7d6b8373d4a7efbb74ebbd4d67ece1d,0,0,0,0,0,
20200429,TN,10366,158183,,,1013,,,,,5140,B,"Tue, 28 Apr 2020 18:00:00 GMT",2020-04-28T18:00:00Z,04/28 14:00,195,1013,2020-04-28T18:00:00Z,47,314,6307,168549,168549,6621,168549,7,119,ead6f0c0e46989a26a108758f5b5a9dccfd401f0,0,0,0,0,0,
20200428,TN,10052,151876,,,894,,,,,4921,B,"Tue, 28 Apr 2020 18:00:00 GMT",2020-04-28T18:00:00Z,04/28 14:00,188,894,2020-04-28T18:00:00Z,47,134,7392,161928,161928,7526,161928,4,57,ce0c48653a8270da423d8d72e17470d0e6753ddc,0,0,0,0,0,
20200427,TN,9918,144484,,,837,,,,,4720,B,"Mon, 27 Apr 2020 18:00:00 GMT",2020-04-27T18:00:00Z,04/27 14:00,184,837,2020-04-27T18:00:00Z,47,251,6677,154402,154402,6928,154402,3,9,18f418038ba50008c54b076ddd53de3e41bda608,0,0,0,0,0,
20200426,TN,9667,137807,,,828,,,,,4527,B,"Sun, 26 Apr 2020 18:00:00 GMT",2020-04-26T18:00:00Z,04/26 14:00,181,828,2020-04-26T18:00:00Z,47,478,5590,147474,147474,6068,147474,3,7,2432bc77517e21d8569c0c6f3b4bfd54dae5a6d2,0,0,0,0,0,
20200425,TN,9189,132217,,,821,,,,,4467,B,"Sat, 25 Apr 2020 18:00:00 GMT",2020-04-25T18:00:00Z,04/25 14:00,178,821,2020-04-25T18:00:00Z,47,463,9615,141406,141406,10078,141406,10,13,73dee0cfe5fd90da60da9502aa7049451ceb2bd7,0,0,0,0,0,
20200424,TN,8726,122602,,,808,,,,,4370,A,"Thu, 23 Apr 2020 18:00:00 GMT",2020-04-23T18:00:00Z,04/23 14:00,168,808,2020-04-23T18:00:00Z,47,460,7768,131328,131328,8228,131328,-2,15,1841e998e708a145151127191c536a8ea00b6d5b,0,0,0,0,0,
20200423,TN,8266,114834,,,793,,,,,4193,A,"Thu, 23 Apr 2020 18:00:00 GMT",2020-04-23T18:00:00Z,04/23 14:00,170,793,2020-04-23T18:00:00Z,47,424,7696,123100,123100,8120,123100,4,18,d3dc7c64d6321ebc23f9e6b3da3c5cca779fd86b,0,0,0,0,0,
20200422,TN,7842,107138,,,775,,,,,4012,A,"Wed, 22 Apr 2020 18:00:00 GMT",2020-04-22T18:00:00Z,04/22 14:00,166,775,2020-04-22T18:00:00Z,47,448,6350,114980,114980,6798,114980,9,15,53129c8cc8b65aadba39e018d416b4d595ad8880,0,0,0,0,0,
20200421,TN,7394,100788,,,760,,,,,3828,A,"Tue, 21 Apr 2020 18:00:00 GMT",2020-04-21T18:00:00Z,04/21 14:00,157,760,2020-04-21T18:00:00Z,47,156,7337,108182,108182,7493,108182,5,30,286e1ec78a6f93d283ac38d07f2d19c51e04a7b4,0,0,0,0,0,
20200420,TN,7238,93451,,,730,,,,,3575,A,"Mon, 20 Apr 2020 18:00:00 GMT",2020-04-20T18:00:00Z,04/20 14:00,152,730,2020-04-20T18:00:00Z,47,168,3423,100689,100689,3591,100689,4,6,9d96a2caf54b6f4f4b40bda284def93327a25cde,0,0,0,0,0,
20200419,TN,7070,90028,,,724,,,,,3344,A,"Sun, 19 Apr 2020 18:00:00 GMT",2020-04-19T18:00:00Z,04/19 14:00,148,724,2020-04-19T18:00:00Z,47,308,6204,97098,97098,6512,97098,3,5,8c4cccf3f45f302c7345e3eacc879680144f320b,0,0,0,0,0,
20200418,TN,6762,83824,,,719,,,,,3234,A,"Sat, 18 Apr 2020 18:00:00 GMT",2020-04-18T18:00:00Z,04/18 14:00,145,719,2020-04-18T18:00:00Z,47,173,3140,90586,90586,3313,90586,3,8,8d6e006ff4780194bb9ad65c81549e36b67de7d9,0,0,0,0,0,
20200417,TN,6589,80684,,,711,,,,,3017,A,"Fri, 17 Apr 2020 18:00:00 GMT",2020-04-17T18:00:00Z,04/17 14:00,142,711,2020-04-17T18:00:00Z,47,327,1897,87273,87273,2224,87273,1,20,f57a213001569706b04870d8dd9b5312e8412dcd,0,0,0,0,0,
20200416,TN,6262,78787,,,691,,,,,2786,A,"Thu, 16 Apr 2020 18:00:00 GMT",2020-04-16T18:00:00Z,04/16 14:00,141,691,2020-04-16T18:00:00Z,47,183,3970,85049,85049,4153,85049,6,28,85f37e1d41e5d28997c255eb41aafa98da5ee2a8,0,0,0,0,0,
20200415,TN,6079,74817,,,663,,,,,2196,A,"Wed, 15 Apr 2020 18:00:00 GMT",2020-04-15T18:00:00Z,04/15 14:00,135,663,2020-04-15T18:00:00Z,47,256,1809,80896,80896,2065,80896,11,30,39be2b2e13c2f4d27f6a18fcb4b1461b304d05e5,0,0,0,0,0,
20200414,TN,5823,73008,,,633,,,,,1969,A,"Tue, 14 Apr 2020 18:00:00 GMT",2020-04-14T18:00:00Z,04/14 14:00,124,633,2020-04-14T18:00:00Z,47,213,2423,78831,78831,2636,78831,15,54,a63ca443563722f4587c1744c49df6fbc73828a0,0,0,0,0,0,
20200413,TN,5610,70585,,,579,,,,,1671,A,"Mon, 13 Apr 2020 18:00:00 GMT",2020-04-13T18:00:00Z,04/13 14:00,109,579,2020-04-13T18:00:00Z,47,302,5216,76195,76195,5518,76195,8,12,73bea6d7bf32a6afbd8738fe1fe2eb12e4fb57ca,0,0,0,0,0,
20200412,TN,5308,65369,,,567,,,,,1504,A,"Sat, 11 Apr 2020 18:00:00 GMT",2020-04-11T18:00:00Z,04/11 14:00,101,567,2020-04-11T18:00:00Z,47,194,3655,70677,70677,3849,70677,0,11,0f82249b8cea00c6ddd1b470f871c1b21b612afb,0,0,0,0,0,
20200411,TN,5114,61714,,,556,,,,,1386,A,"Sat, 11 Apr 2020 18:00:00 GMT",2020-04-11T18:00:00Z,04/11 14:00,101,556,2020-04-11T18:00:00Z,47,252,3777,66828,66828,4029,66828,3,20,432a0e52f907edc22bf77625c073bb113435159b,0,0,0,0,0,
20200410,TN,4862,57937,,,536,,,,,1145,A,"Fri, 10 Apr 2020 18:00:00 GMT",2020-04-10T18:00:00Z,04/10 14:00,98,536,2020-04-10T18:00:00Z,47,228,2722,62799,62799,2950,62799,4,31,d628dc483cda5c7b71d76ae35047d2780ec3959c,0,0,0,0,0,
20200409,TN,4634,55215,,,505,,,,,921,A,"Thu, 09 Apr 2020 18:00:00 GMT",2020-04-09T18:00:00Z,04/09 14:00,94,505,2020-04-09T18:00:00Z,47,272,2959,59849,59849,3231,59849,15,56,300fa0c9eba547019a46d6155a355dc29b3ad9e5,0,0,0,0,0,
20200408,TN,4362,52256,,,449,,,,,592,A,"Wed, 08 Apr 2020 18:00:00 GMT",2020-04-08T18:00:00Z,04/08 14:00,79,449,2020-04-08T18:00:00Z,47,224,3520,56618,56618,3744,56618,7,41,acca621dda89ce33c4e9dd63871f05166ba25a55,0,0,0,0,0,
20200407,TN,4138,48736,,,408,,,,,466,A,"Tue, 07 Apr 2020 18:00:00 GMT",2020-04-07T18:00:00Z,04/07 14:00,72,408,2020-04-07T18:00:00Z,47,336,5188,52874,52874,5524,52874,7,56,6345864cd8c8acce8a5901fd08d82ac600bd0b24,0,0,0,0,0,
20200406,TN,3802,43548,,,352,,,,,356,A,"Mon, 06 Apr 2020 18:00:00 GMT",2020-04-06T18:00:00Z,04/06 14:00,65,352,2020-04-06T18:00:00Z,47,169,1881,47350,47350,2050,47350,21,24,87c5ed1a74e6976d0ed5c67c65768cd69374849e,0,0,0,0,0,
20200405,TN,3633,41667,,,328,,,,,295,A,"Sat, 04 Apr 2020 18:00:00 GMT",2020-04-04T18:00:00Z,04/04 14:00,44,328,2020-04-04T18:00:00Z,47,312,3597,45300,45300,3909,45300,1,17,345292401599b2d8efa4763fd18ff3c6d40dfbb5,0,0,0,0,0,
20200404,TN,3321,38070,,,311,,,,,416,A,"Sat, 04 Apr 2020 18:00:00 GMT",2020-04-04T18:00:00Z,04/04 14:00,43,311,2020-04-04T18:00:00Z,47,254,3298,41391,41391,3552,41391,6,18,c3bef67d9274d51d01adaddaa6ee011e3b1c08e9,0,0,0,0,0,
20200403,TN,3067,34772,,,293,,,,,248,A,"Fri, 03 Apr 2020 18:00:00 GMT",2020-04-03T18:00:00Z,04/03 14:00,37,293,2020-04-03T18:00:00Z,47,222,3006,37839,37839,3228,37839,5,30,ff6f97cf23d832fcf67509c0e0571e15b473bdec,0,0,0,0,0,
20200402,TN,2845,31766,,,263,,,,,220,A,"Thu, 02 Apr 2020 18:00:00 GMT",2020-04-02T18:00:00Z,04/02 14:00,32,263,2020-04-02T18:00:00Z,47,162,1997,34611,34611,2159,34611,8,63,61265809c84e2f49ba4ac82db7fb8d72dc2c6d0a,0,0,0,0,0,
20200401,TN,2683,29769,,,200,,,,,137,A,"Wed, 01 Apr 2020 18:00:00 GMT",2020-04-01T18:00:00Z,04/01 14:00,24,200,2020-04-01T18:00:00Z,47,444,4648,32452,32452,5092,32452,1,25,75148a768c5ba0463809768a4098407a46cfa214,0,0,0,0,0,
20200331,TN,2239,25121,,,175,,,,,121,A,"Tue, 31 Mar 2020 18:00:00 GMT",2020-03-31T18:00:00Z,03/31 14:00,23,175,2020-03-31T18:00:00Z,47,405,3651,27360,27360,4056,27360,10,27,702f494efb2b9a0e985f854079ae1968fc24a963,0,0,0,0,0,
20200330,TN,1834,21470,,,148,,,,,,A,"Mon, 30 Mar 2020 18:00:00 GMT",2020-03-30T18:00:00Z,03/30 14:00,13,148,2020-03-30T18:00:00Z,47,297,2433,23304,23304,2730,23304,6,15,91a3299bd27baf44fef97374ebece837dc26955d,0,0,0,0,0,
20200329,TN,1537,19037,,,133,,,,,,A,"Sun, 29 Mar 2020 18:00:00 GMT",2020-03-29T18:00:00Z,03/29 14:00,7,133,2020-03-29T18:00:00Z,47,164,2072,20574,20574,2236,20574,1,15,4f86ab0820b6c175a81a31dd18bae5ef349227c8,0,0,0,0,0,
20200328,TN,1373,16965,,,118,,,,,,A,"Fri, 27 Mar 2020 18:00:00 GMT",2020-03-27T18:00:00Z,03/27 14:00,6,118,2020-03-27T18:00:00Z,47,170,2077,18338,18338,2247,18338,0,15,e6427c4a7bfc74a5cb7dbb134955e87606cc81fc,0,0,0,0,0,
20200327,TN,1203,14888,,,103,,,,,,A,"Fri, 27 Mar 2020 18:00:00 GMT",2020-03-27T18:00:00Z,03/27 14:00,6,103,2020-03-27T18:00:00Z,47,246,936,16091,16091,1182,16091,3,27,10c502928af78a4e9da383a839095adc7a139f90,0,0,0,0,0,
20200326,TN,957,13952,,,76,,,,,,A,"Thu, 26 Mar 2020 18:00:00 GMT",2020-03-26T18:00:00Z,03/26 14:00,3,76,2020-03-26T18:00:00Z,47,173,2940,14909,14909,3113,14909,0,23,46d51db9cf9c95762df4775f9e1a49a81d653446,0,0,0,0,0,
20200325,TN,784,11012,,,53,,,,,,A,"Wed, 25 Mar 2020 18:00:00 GMT",2020-03-25T18:00:00Z,03/25 14:00,3,53,2020-03-25T18:00:00Z,47,117,495,11796,11796,612,11796,1,53,7c0af5d23acfc1b880772e917cf55a503dbc3ab7,0,0,0,0,0,
20200324,TN,667,10517,,,,,,,,,A,"Tue, 24 Mar 2020 18:00:00 GMT",2020-03-24T18:00:00Z,03/24 14:00,2,,2020-03-24T18:00:00Z,47,52,7245,11184,11184,7297,11184,0,0,bd75ed2443c95b4196e2da99742bc96ea146f6d6,0,0,0,0,0,
20200323,TN,615,3272,,,,,,,,,B,"Mon, 23 Mar 2020 18:00:00 GMT",2020-03-23T18:00:00Z,03/23 14:00,2,,2020-03-23T18:00:00Z,47,110,0,3887,3887,110,3887,2,0,28c7e9bb41e79eac9653635894aebf1a676790dd,0,0,0,0,0,
20200322,TN,505,3272,,,,,,,,,,"Sun, 22 Mar 2020 18:00:00 GMT",2020-03-22T18:00:00Z,03/22 14:00,,,2020-03-22T18:00:00Z,47,134,0,3777,3777,134,3777,0,0,38b3782d021ce7d276e97feea2a9ff60752c5f20,0,0,0,0,0,
20200321,TN,371,3272,,,,,,,,,,"Sat, 21 Mar 2020 01:48:00 GMT",2020-03-21T01:48:00Z,03/20 21:48,,,2020-03-21T01:48:00Z,47,143,2709,3643,3643,2852,3643,0,0,f38cc2fc8743ee89f4a5de0e274fb6060ce75349,0,0,0,0,0,
20200320,TN,228,563,,,,,,,,,,"Fri, 20 Mar 2020 18:00:00 GMT",2020-03-20T18:00:00Z,03/20 14:00,,,2020-03-20T18:00:00Z,47,74,214,791,791,288,791,0,0,2788dfbeb9ee9cb5766562db5523134cb90fb9dc,0,0,0,0,0,
20200319,TN,154,349,,,,,,,,,,"Thu, 19 Mar 2020 18:00:00 GMT",2020-03-19T18:00:00Z,03/19 14:00,,,2020-03-19T18:00:00Z,47,56,0,503,503,56,503,0,0,977b6ed58696cb7e82dd58ce62ec8245ab9309f2,0,0,0,0,0,
20200318,TN,98,349,,,,,,,,,,"Tue, 17 Mar 2020 18:00:00 GMT",2020-03-17T18:00:00Z,03/17 14:00,,,2020-03-17T18:00:00Z,47,25,19,447,447,44,447,0,0,ed9a2442c84904a685c33a8589e1bf335da1ff6d,0,0,0,0,0,
20200317,TN,73,330,,,,,,,,,,"Tue, 17 Mar 2020 18:00:00 GMT",2020-03-17T18:00:00Z,03/17 14:00,,,2020-03-17T18:00:00Z,47,21,60,403,403,81,403,0,0,8de3a93fe324496d863cddf7052b01d5dce84431,0,0,0,0,0,
20200316,TN,52,270,,,,,,,,,,"Mon, 16 Mar 2020 18:23:00 GMT",2020-03-16T18:23:00Z,03/16 14:23,,,2020-03-16T18:23:00Z,47,13,113,322,322,126,322,0,0,a50f6bff4da3c1209af1db21f2fefa3041d2eb61,0,0,0,0,0,
20200315,TN,39,157,,,,,,,,,,"Sun, 15 Mar 2020 18:00:00 GMT",2020-03-15T18:00:00Z,03/15 14:00,,,2020-03-15T18:00:00Z,47,7,27,196,196,34,196,0,0,1b9d7b81c6d12e4c0d1f49df5aeb5cf6ddd84f3e,0,0,0,0,0,
20200314,TN,32,130,,,,,,,,,,"Sat, 14 Mar 2020 18:00:00 GMT",2020-03-14T18:00:00Z,03/14 14:00,,,2020-03-14T18:00:00Z,47,6,14,162,162,20,162,0,0,d93f3c41a4cef96be8dc0b6fb38632483730c54e,0,0,0,0,0,
20200313,TN,26,116,,,,,,,,,,"Fri, 13 Mar 2020 03:00:00 GMT",2020-03-13T03:00:00Z,03/12 23:00,,,2020-03-13T03:00:00Z,47,8,37,142,142,45,142,0,0,a6fbc0d8d1a475005586fec6e47e90fe2a0dcd9b,0,0,0,0,0,
20200312,TN,18,79,,,,,,,,,,"Thu, 12 Mar 2020 18:00:00 GMT",2020-03-12T18:00:00Z,03/12 14:00,,,2020-03-12T18:00:00Z,47,11,29,97,97,40,97,0,0,d1136942d929f66d1262e9d4290db9371a64d639,0,0,0,0,0,
20200311,TN,7,50,,,,,,,,,,,,,,,,47,0,50,57,57,50,57,0,0,87dc594756c62a5c4ab90f8b3974670f96796f1e,0,0,0,0,0,
20200310,TN,7,,,,,,,,,,,,,,,,,47,4,0,7,7,4,7,0,0,683688658c6dd4d268ee25bb2ab7d55afa885f1a,0,0,0,0,0,
20200309,TN,3,,,,,,,,,,,,,,,,,47,0,0,3,3,0,3,0,0,05aa9bf391702965391ff7c98b0175b5fb1b654e,0,0,0,0,0,
20200308,TN,3,,,,,,,,,,,,,,,,,47,2,0,3,3,2,3,0,0,a7799c07ec8770d5f202b85b93b5de8015a9e1b9,0,0,0,0,0,
20200307,TN,1,,,,,,,,,,,,,,,,,47,0,0,1,1,0,1,0,0,0e55236bcbf5eb96dfb88d2b6f6af5d627cdccaa,0,0,0,0,0,
20200306,TN,1,,,,,,,,,,,,,,,,,47,0,0,1,1,0,1,0,0,29d49d516845372e527765dc1c5d6c41b3e03b72,0,0,0,0,0,
20200305,TN,1,,,,,,,,,,,,,,,,,47,0,0,1,1,0,1,0,0,ccc5cfbc3c62a4a99d8290034d52625dd533b9d4,0,0,0,0,0,
